"","STATION_KEY","duration","y0","Y1","nobs","long","lat","parameter"
"1",10085,8,2002,2010,6,-123.049056,43.808556,"total suspended solids"
"2",10086,9,2001,2010,4,-123.253139,44.921472,"total suspended solids"
"3",10087,0,2002,2002,1,-122.709167,42.211111,"total suspended solids"
"4",10150,0,2002,2002,3,-123.266111,44.041111,"total suspended solids"
"5",10151,2,2001,2003,16,-123.268611,44.005278,"total suspended solids"
"6",10322,0,2003,2003,2,-123.2825,45.626111,"total suspended solids"
"7",10332,13,2001,2014,75,-122.7475,45.577944,"total suspended solids"
"8",10336,0,2003,2003,2,-122.654111,45.418583,"total suspended solids"
"9",10339,13,2001,2014,86,-122.690722,45.300333,"total suspended solids"
"10",10342,10,2001,2011,20,-122.942361,45.267639,"total suspended solids"
"11",10344,12,2001,2013,74,-123.044306,45.090583,"total suspended solids"
"12",10350,13,2001,2014,105,-123.105778,44.639722,"total suspended solids"
"13",10352,13,2001,2014,123,-123.255417,44.565528,"total suspended solids"
"14",10355,13,2001,2014,115,-123.173667,44.267167,"total suspended solids"
"15",10359,13,2001,2014,60,-123.02675,44.045611,"total suspended solids"
"16",10360,2,2008,2010,5,-122.600222,45.373528,"total suspended solids"
"17",10363,13,2001,2014,106,-123.071583,45.223639,"total suspended solids"
"18",10364,0,2003,2003,8,-123.1463,44.928,"total suspended solids"
"19",10366,13,2001,2014,67,-122.923556,44.636194,"total suspended solids"
"20",10372,4,2004,2008,8,-123.111667,44.635556,"total suspended solids"
"21",10373,13,2001,2014,78,-123.263639,44.556639,"total suspended solids"
"22",10375,6,2002,2008,13,-123.294722,44.313028,"total suspended solids"
"23",10376,13,2001,2014,74,-123.046194,44.112722,"total suspended solids"
"24",10379,7,2004,2011,15,-122.9655,43.981,"total suspended solids"
"25",10386,13,2001,2014,67,-122.905278,43.998194,"total suspended solids"
"26",10391,13,2001,2014,66,-123.9135,44.7643,"total suspended solids"
"27",10392,5,2001,2006,19,-123.852139,44.030139,"total suspended solids"
"28",10393,13,2001,2014,66,-124.136694,43.078528,"total suspended solids"
"29",10398,0,2003,2003,1,-116.999361,43.866639,"total suspended solids"
"30",10401,1,2005,2006,3,-119.146514,44.415989,"total suspended solids"
"31",10404,13,2001,2014,85,-119.035389,45.677444,"total suspended solids"
"32",10405,0,2005,2005,2,-118.875611,45.65775,"total suspended solids"
"33",10406,13,2001,2014,74,-118.7585,45.674806,"total suspended solids"
"34",10407,13,2001,2014,72,-116.972222,44.05675,"total suspended solids"
"35",10408,0,2006,2006,2,-117.141361,44.000222,"total suspended solids"
"36",10410,13,2001,2014,65,-117.719639,45.621306,"total suspended solids"
"37",10411,13,2001,2014,82,-120.910167,45.630222,"total suspended solids"
"38",10414,13,2001,2014,62,-124.292167,42.503667,"total suspended solids"
"39",10418,13,2001,2014,68,-123.487278,42.496833,"total suspended solids"
"40",10421,13,2001,2014,75,-123.089389,42.432694,"total suspended solids"
"41",10423,13,2001,2014,86,-122.841583,42.525333,"total suspended solids"
"42",10428,11,2001,2012,43,-123.455833,42.3975,"total suspended solids"
"43",10430,6,2002,2008,54,-122.898833,42.38225,"total suspended solids"
"44",10433,6,2002,2008,51,-122.818333,42.280278,"total suspended solids"
"45",10434,9,2002,2011,53,-122.744944,42.224417,"total suspended solids"
"46",10437,13,2001,2014,58,-123.565833,43.631861,"total suspended solids"
"47",10440,0,2002,2002,3,-123.467,43.366167,"total suspended solids"
"48",10441,13,2001,2014,56,-123.563444,43.635139,"total suspended solids"
"49",10442,13,2001,2014,69,-123.411056,43.241778,"total suspended solids"
"50",10443,13,2001,2014,55,-123.397944,43.133889,"total suspended solids"
"51",10444,0,2002,2002,1,-123.294889,43.025444,"total suspended solids"
"52",10445,0,2002,2002,2,-123.284667,42.944056,"total suspended solids"
"53",10451,13,2001,2014,54,-123.409222,43.271861,"total suspended solids"
"54",10456,13,2001,2014,71,-122.756278,45.386139,"total suspended solids"
"55",10458,13,2001,2014,66,-122.893667,45.409389,"total suspended solids"
"56",10459,13,2001,2014,67,-122.919778,45.444415,"total suspended solids"
"57",10461,13,2001,2014,67,-122.950556,45.490056,"total suspended solids"
"58",10469,13,2001,2014,77,-122.752778,45.415472,"total suspended solids"
"59",10480,13,2001,2014,61,-122.89875,45.520861,"total suspended solids"
"60",10506,13,2001,2014,58,-121.227806,44.761167,"total suspended solids"
"61",10508,13,2001,2014,72,-121.293778,44.359917,"total suspended solids"
"62",10509,1,2001,2002,7,-121.253861,44.268139,"total suspended solids"
"63",10511,12,2002,2014,59,-121.320444,44.060083,"total suspended solids"
"64",10517,13,2001,2014,71,-121.080694,44.348694,"total suspended solids"
"65",10521,13,2001,2014,41,-123.9251,45.952,"total suspended solids"
"66",10523,13,2001,2014,85,-123.8902,45.2071,"total suspended solids"
"67",10533,13,2001,2014,39,-124.481417,42.81675,"total suspended solids"
"68",10535,1,2008,2009,8,-124.352306,42.277056,"total suspended solids"
"69",10537,13,2001,2014,33,-124.186139,42.007139,"total suspended solids"
"70",10555,13,2001,2014,114,-123.041528,44.946111,"total suspended solids"
"71",10565,0,2006,2006,1,-123.099528,44.600278,"total suspended solids"
"72",10573,0,2002,2002,2,-121.838333,42.158889,"total suspended solids"
"73",10575,0,2002,2002,1,-123.075444,44.662444,"total suspended solids"
"74",10577,8,2002,2010,8,-123.080278,44.6445,"total suspended solids"
"75",10578,5,2005,2010,4,-123.764444,46.209722,"total suspended solids"
"76",10579,9,2004,2013,11,-122.642583,45.440333,"total suspended solids"
"77",10580,3,2007,2010,2,-124.217639,43.390556,"total suspended solids"
"78",10585,0,2008,2008,3,-123.751139,44.376111,"total suspended solids"
"79",10588,0,2008,2008,1,-123.875583,44.534556,"total suspended solids"
"80",10596,13,2001,2014,85,-124.192528,43.173778,"total suspended solids"
"81",10602,13,2001,2014,82,-122.855028,42.455444,"total suspended solids"
"82",10611,13,2001,2014,111,-122.669889,45.513306,"total suspended solids"
"83",10616,13,2001,2014,61,-122.738861,45.645639,"total suspended solids"
"84",10637,13,2001,2014,60,-122.709222,45.267667,"total suspended solids"
"85",10638,0,2008,2008,1,-122.537028,45.162694,"total suspended solids"
"86",10640,13,2001,2014,64,-122.792528,45.150361,"total suspended solids"
"87",10646,2,2005,2007,27,-122.824194,45.006583,"total suspended solids"
"88",10652,0,2003,2003,7,-123.02275,44.945222,"total suspended solids"
"89",10655,1,2002,2003,13,-123.037944,44.936111,"total suspended solids"
"90",10658,0,2002,2002,6,-123.161389,44.730361,"total suspended solids"
"91",10659,6,2002,2008,16,-123.235333,44.782778,"total suspended solids"
"92",10661,0,2002,2002,3,-123.355056,44.060444,"total suspended solids"
"93",10662,12,2001,2013,79,-122.831222,44.055278,"total suspended solids"
"94",10663,13,2001,2014,37,-122.959333,44.092306,"total suspended solids"
"95",10674,13,2001,2014,61,-122.375444,45.5385,"total suspended solids"
"96",10684,10,2002,2012,4,-121.410667,43.930806,"total suspended solids"
"97",10686,13,2001,2014,65,-121.451194,43.863361,"total suspended solids"
"98",10687,1,2001,2002,4,-121.4981,43.8174,"total suspended solids"
"99",10688,13,2001,2014,56,-121.607028,43.743417,"total suspended solids"
"100",10689,11,2001,2012,10,-121.688722,43.684417,"total suspended solids"
"101",10690,10,2003,2013,22,-121.619528,44.5565,"total suspended solids"
"102",10694,0,2002,2002,1,-121.463333,43.873028,"total suspended solids"
"103",10696,12,2002,2014,55,-121.4513,43.8204,"total suspended solids"
"104",10697,10,2002,2012,5,-121.500167,43.692306,"total suspended solids"
"105",10698,1,2001,2002,3,-121.572028,43.661806,"total suspended solids"
"106",10699,0,2002,2002,2,-121.6516,43.5248,"total suspended solids"
"107",10703,0,2002,2002,2,-121.696889,43.463472,"total suspended solids"
"108",10705,0,2002,2002,2,-121.5315,43.7943,"total suspended solids"
"109",10708,0,2011,2011,3,-120.023139,45.739806,"total suspended solids"
"110",10719,13,2001,2014,65,-117.909278,45.566889,"total suspended solids"
"111",10720,13,2001,2014,62,-118.235556,45.342111,"total suspended solids"
"112",10724,13,2001,2014,66,-117.4675,44.818333,"total suspended solids"
"113",10727,0,2006,2006,3,-117.363972,43.939472,"total suspended solids"
"114",10728,13,2001,2014,67,-117.229167,43.988056,"total suspended solids"
"115",10729,13,2001,2014,68,-117.054333,43.783861,"total suspended solids"
"116",10730,6,2008,2014,11,-117.622806,42.840694,"total suspended solids"
"117",10741,12,2002,2014,14,-119.901056,42.407139,"total suspended solids"
"118",10743,2,2001,2003,6,-120.545028,42.696083,"total suspended solids"
"119",10751,7,2001,2008,5,-120.389389,42.19325,"total suspended solids"
"120",10758,0,2003,2003,4,-121.560417,42.010278,"total suspended solids"
"121",10759,13,2001,2014,62,-121.622667,42.040417,"total suspended solids"
"122",10762,0,2003,2003,3,-121.757694,42.154,"total suspended solids"
"123",10763,13,2001,2014,72,-121.840722,42.079917,"total suspended solids"
"124",10764,13,2001,2014,55,-122.059917,42.086917,"total suspended solids"
"125",10765,13,2001,2014,69,-121.927778,42.128056,"total suspended solids"
"126",10767,0,2002,2002,3,-121.797722,42.174944,"total suspended solids"
"127",10768,13,2001,2014,78,-121.788361,42.218778,"total suspended solids"
"128",10770,13,2001,2014,57,-121.916194,42.514611,"total suspended solids"
"129",10775,9,2002,2011,15,-123.012861,44.715389,"total suspended solids"
"130",10783,2,2012,2014,15,-122.936889,44.690667,"total suspended solids"
"131",10784,2,2012,2014,15,-122.917806,44.673389,"total suspended solids"
"132",10792,13,2001,2014,63,-122.971111,44.708722,"total suspended solids"
"133",10801,13,2001,2014,75,-122.709083,45.563806,"total suspended solids"
"134",10811,0,2003,2003,3,-123.915833,46.168583,"total suspended solids"
"135",10812,13,2001,2014,69,-123.924361,46.148972,"total suspended solids"
"136",10813,0,2003,2003,1,-123.9089,46.0944,"total suspended solids"
"137",10817,13,2001,2014,67,-123.839972,46.075028,"total suspended solids"
"138",10821,7,2004,2011,15,-122.763889,45.584722,"total suspended solids"
"139",10832,0,2003,2003,2,-122.6085,45.359333,"total suspended solids"
"140",10833,4,2007,2011,8,-122.640194,45.340472,"total suspended solids"
"141",10853,1,2001,2002,8,-122.568333,45.467778,"total suspended solids"
"142",10896,2,2005,2007,8,-122.7804,45.1477,"total suspended solids"
"143",10899,4,2005,2009,56,-122.8225,45.1004,"total suspended solids"
"144",10909,3,2011,2014,9,-123.842194,44.731917,"total suspended solids"
"145",10916,1,2004,2005,4,-122.654417,45.340528,"total suspended solids"
"146",10917,13,2001,2014,123,-122.748972,45.233806,"total suspended solids"
"147",10924,0,2007,2007,12,-123.108389,45.240194,"total suspended solids"
"148",10929,13,2001,2014,110,-123.17417,45.25194,"total suspended solids"
"149",10948,12,2001,2013,72,-123.206917,45.168667,"total suspended solids"
"150",10949,0,2009,2009,1,-123.263222,45.107917,"total suspended solids"
"151",10957,0,2008,2008,4,-123.211806,45.116167,"total suspended solids"
"152",10991,1,2002,2003,3,-122.967528,43.789139,"total suspended solids"
"153",10996,13,2001,2014,97,-123.459528,43.366361,"total suspended solids"
"154",10997,12,2002,2014,39,-123.33575,42.943861,"total suspended solids"
"155",11003,0,2014,2014,1,-123.86088,45.229944,"total suspended solids"
"156",11005,0,2013,2013,1,-123.825667,45.277444,"total suspended solids"
"157",11016,0,2012,2012,3,-119.540028,44.475222,"total suspended solids"
"158",11017,13,2001,2014,61,-119.637694,44.756,"total suspended solids"
"159",11020,13,2001,2014,67,-119.531222,44.465639,"total suspended solids"
"160",11025,0,2012,2012,3,-122.277278,45.493361,"total suspended solids"
"161",11043,13,2001,2014,63,-117.268861,43.967306,"total suspended solids"
"162",11044,0,2006,2006,2,-117.603722,43.854389,"total suspended solids"
"163",11047,11,2003,2014,12,-118.331778,43.783778,"total suspended solids"
"164",11050,2,2011,2013,8,-117.518556,42.904917,"total suspended solids"
"165",11051,13,2001,2014,131,-122.937722,42.404722,"total suspended solids"
"166",11111,0,2002,2002,6,-123.46775,44.681778,"total suspended solids"
"167",11113,0,2002,2002,5,-123.180833,44.724889,"total suspended solids"
"168",11114,0,2002,2002,7,-123.2915,44.797194,"total suspended solids"
"169",11118,0,2002,2002,2,-123.386833,44.847944,"total suspended solids"
"170",11123,6,2002,2008,62,-122.937306,42.403972,"total suspended solids"
"171",11125,1,2007,2008,27,-122.924778,42.3895,"total suspended solids"
"172",11128,6,2002,2008,89,-122.844667,42.314667,"total suspended solids"
"173",11130,6,2002,2008,80,-122.779056,42.245556,"total suspended solids"
"174",11133,6,2002,2008,85,-122.652139,42.185472,"total suspended solids"
"175",11137,2,2001,2003,20,-123.285528,44.248333,"total suspended solids"
"176",11138,2,2001,2003,19,-123.291417,44.216056,"total suspended solids"
"177",11140,13,2001,2014,97,-123.294444,44.342861,"total suspended solids"
"178",11142,0,2002,2002,5,-123.301639,44.118472,"total suspended solids"
"179",11144,0,2002,2002,1,-123.426861,44.148111,"total suspended solids"
"180",11148,0,2002,2002,3,-123.306083,43.99175,"total suspended solids"
"181",11150,0,2002,2002,3,-123.261389,44.005,"total suspended solids"
"182",11178,0,2002,2002,2,-121.777333,42.216833,"total suspended solids"
"183",11180,13,2001,2014,79,-123.127472,44.620222,"total suspended solids"
"184",11181,0,2013,2013,4,-123.148194,44.565583,"total suspended solids"
"185",11182,11,2003,2014,24,-123.107472,44.504611,"total suspended solids"
"186",11188,11,2003,2014,21,-123.112306,44.603556,"total suspended solids"
"187",11201,13,2001,2014,84,-122.753056,45.6105,"total suspended solids"
"188",11226,0,2002,2002,6,-123.842806,45.902083,"total suspended solids"
"189",11233,13,2001,2014,58,-122.583139,45.378722,"total suspended solids"
"190",11241,13,2001,2014,57,-123.944972,45.023417,"total suspended solids"
"191",11246,3,2011,2014,11,-123.790917,44.742722,"total suspended solids"
"192",11263,13,2001,2014,57,-123.831,44.382694,"total suspended solids"
"193",11275,13,2001,2014,79,-122.985111,44.010028,"total suspended solids"
"194",11278,0,2002,2002,3,-123.049139,43.718028,"total suspended solids"
"195",11304,1,2001,2002,6,-123.337306,43.658306,"total suspended solids"
"196",11305,1,2001,2002,7,-123.316139,43.660361,"total suspended solids"
"197",11306,4,2001,2005,7,-123.279333,43.604222,"total suspended solids"
"198",11310,0,2002,2002,11,-123.341361,43.2135,"total suspended solids"
"199",11316,0,2002,2002,1,-123.294944,43.022944,"total suspended solids"
"200",11321,13,2001,2014,75,-122.64225,45.447167,"total suspended solids"
"201",11323,1,2001,2002,8,-122.616111,45.461667,"total suspended solids"
"202",11326,1,2001,2002,7,-122.467778,45.486111,"total suspended solids"
"203",11375,0,2011,2011,1,-122.698944,42.659361,"total suspended solids"
"204",11386,13,2001,2014,63,-120.468639,45.476861,"total suspended solids"
"205",11387,0,2012,2012,3,-121.095528,45.239944,"total suspended solids"
"206",11428,0,2001,2001,4,-123.843083,45.768361,"total suspended solids"
"207",11434,13,2001,2014,71,-123.197583,46.102028,"total suspended solids"
"208",11457,12,2002,2014,43,-117.729944,45.619556,"total suspended solids"
"209",11476,13,2001,2014,74,-123.834778,44.657667,"total suspended solids"
"210",11477,12,2002,2014,68,-120.541139,44.172556,"total suspended solids"
"211",11478,13,2001,2014,95,-120.002694,44.792417,"total suspended solids"
"212",11479,13,2001,2014,68,-119.470494,44.466331,"total suspended solids"
"213",11480,13,2001,2014,74,-117.507583,43.910333,"total suspended solids"
"214",11482,12,2002,2014,33,-123.68675,42.238389,"total suspended solids"
"215",11483,13,2001,2014,34,-124.185889,42.123722,"total suspended solids"
"216",11484,12,2002,2014,50,-123.21575,42.970944,"total suspended solids"
"217",11485,12,2001,2013,60,-124.113167,43.032944,"total suspended solids"
"218",11486,13,2001,2014,75,-124.149333,43.008528,"total suspended solids"
"219",11489,13,2001,2014,68,-119.331944,45.835694,"total suspended solids"
"220",11490,13,2001,2014,92,-117.826667,44.781944,"total suspended solids"
"221",11491,7,2007,2014,43,-123.861972,43.788778,"total suspended solids"
"222",11493,13,2001,2014,47,-124.395556,42.272222,"total suspended solids"
"223",11494,13,2001,2014,68,-117.251947,44.356872,"total suspended solids"
"224",11495,7,2003,2010,4,-122.891111,44.548333,"total suspended solids"
"225",11505,2,2006,2008,23,-123.199583,45.152722,"total suspended solids"
"226",11506,6,2002,2008,51,-122.775333,42.245472,"total suspended solids"
"227",11514,4,2005,2009,41,-122.783333,45.095333,"total suspended solids"
"228",11515,4,2005,2009,47,-122.787222,45.088222,"total suspended solids"
"229",11521,13,2001,2014,51,-117.962611,45.349722,"total suspended solids"
"230",11522,13,2001,2014,76,-123.365556,43.217778,"total suspended solids"
"231",11523,6,2002,2008,48,-122.709861,42.215139,"total suspended solids"
"232",11527,8,2002,2010,7,-123.178333,45.214444,"total suspended solids"
"233",11538,8,2002,2010,3,-122.905889,42.438139,"total suspended solids"
"234",11539,8,2002,2010,5,-123.116111,44.094722,"total suspended solids"
"235",11541,0,2010,2010,1,-124.253056,43.415556,"total suspended solids"
"236",11542,0,2005,2005,2,-122.650278,45.424444,"total suspended solids"
"237",11543,7,2003,2010,2,-118.838861,45.668556,"total suspended solids"
"238",11544,8,2002,2010,9,-122.700028,45.614333,"total suspended solids"
"239",11545,8,2002,2010,7,-123.395722,43.211056,"total suspended solids"
"240",11547,4,2002,2006,5,-123.053611,45.009444,"total suspended solids"
"241",11548,1,2006,2007,2,-122.796944,45.865,"total suspended solids"
"242",11549,11,2002,2013,8,-121.183889,45.605278,"total suspended solids"
"243",11550,0,2003,2003,1,-123.837333,45.485667,"total suspended solids"
"244",11551,8,2001,2009,5,-122.759444,45.404167,"total suspended solids"
"245",11555,9,2002,2011,10,-122.656667,45.417778,"total suspended solids"
"246",11556,8,2002,2010,5,-123.201111,42.41875,"total suspended solids"
"247",11558,0,2002,2002,1,-121.769222,42.197278,"total suspended solids"
"248",11571,5,2001,2006,9,-124.105972,43.071667,"total suspended solids"
"249",11573,1,2001,2002,6,-124.345778,43.135056,"total suspended solids"
"250",11586,0,2008,2008,2,-117.231772,45.397994,"total suspended solids"
"251",11587,0,2008,2008,1,-117.232644,45.398289,"total suspended solids"
"252",11598,0,2003,2003,7,-121.790667,42.178444,"total suspended solids"
"253",11600,0,2002,2002,2,-121.781694,42.192389,"total suspended solids"
"254",11614,6,2002,2008,47,-122.651361,42.193083,"total suspended solids"
"255",11626,8,2001,2009,38,-122.402278,45.473056,"total suspended solids"
"256",11686,0,2002,2002,1,-124.141972,43.082194,"total suspended solids"
"257",11692,1,2001,2002,5,-124.185889,43.096472,"total suspended solids"
"258",11698,0,2007,2007,5,-124.189139,43.124528,"total suspended solids"
"259",11704,0,2007,2007,5,-124.222139,43.177139,"total suspended solids"
"260",11721,1,2001,2002,7,-124.357167,43.164833,"total suspended solids"
"261",11724,0,2007,2007,2,-124.146611,43.06975,"total suspended solids"
"262",11725,2,2007,2009,5,-124.193667,43.173583,"total suspended solids"
"263",11768,1,2001,2002,5,-124.289528,43.116111,"total suspended solids"
"264",11778,1,2005,2006,5,-120.793333,44.109722,"total suspended solids"
"265",11783,0,2010,2010,1,-123.186583,45.855056,"total suspended solids"
"266",11787,0,2001,2001,2,-123.189194,45.855556,"total suspended solids"
"267",11788,0,2009,2009,1,-123.18475,45.855639,"total suspended solids"
"268",11824,9,2001,2010,5,-122.802694,45.008694,"total suspended solids"
"269",11826,0,2009,2009,1,-120.599778,45.702889,"total suspended solids"
"270",11850,0,2007,2007,1,-124.105722,44.186639,"total suspended solids"
"271",11856,13,2001,2014,75,-123.842444,45.700361,"total suspended solids"
"272",11857,0,2011,2011,3,-117.171833,44.74625,"total suspended solids"
"273",11868,1,2001,2002,3,-124.176556,43.458028,"total suspended solids"
"274",11871,1,2001,2002,5,-124.139667,43.476806,"total suspended solids"
"275",11872,1,2001,2002,4,-124.119972,43.487917,"total suspended solids"
"276",11876,0,2002,2002,1,-124.198389,43.466972,"total suspended solids"
"277",11878,1,2001,2002,3,-124.32425,43.346417,"total suspended solids"
"278",11882,1,2001,2002,3,-124.318083,43.276472,"total suspended solids"
"279",11884,6,2001,2007,27,-124.208111,43.356306,"total suspended solids"
"280",11904,13,2001,2014,72,-123.751111,46.091167,"total suspended solids"
"281",11905,13,2001,2014,38,-124.487889,42.794389,"total suspended solids"
"282",11933,11,2002,2013,10,-121.768944,42.196111,"total suspended solids"
"283",11935,0,2002,2002,1,-123.799806,45.426222,"total suspended solids"
"284",11940,9,2002,2011,8,-122.7695,45.294167,"total suspended solids"
"285",11943,0,2006,2006,1,-122.759889,45.293111,"total suspended solids"
"286",11968,0,2005,2005,1,-121.543222,45.626444,"total suspended solids"
"287",11969,0,2005,2005,1,-121.543889,45.627972,"total suspended solids"
"288",11971,0,2005,2005,3,-121.512917,45.644222,"total suspended solids"
"289",11972,10,2002,2012,33,-121.51517,45.64377,"total suspended solids"
"290",11973,0,2005,2005,2,-121.52925,45.627583,"total suspended solids"
"291",11974,0,2005,2005,2,-121.527333,45.627722,"total suspended solids"
"292",12005,13,2001,2014,81,-118.823028,45.654444,"total suspended solids"
"293",12012,13,2001,2014,104,-121.506722,45.710722,"total suspended solids"
"294",12015,0,2011,2011,4,-119.341281,45.784772,"total suspended solids"
"295",12053,0,2001,2001,1,-118.4025,45.2624,"total suspended solids"
"296",12054,0,2001,2001,1,-118.4043,45.2627,"total suspended solids"
"297",12055,0,2002,2002,1,-118.4287,45.2697,"total suspended solids"
"298",12057,1,2002,2003,3,-118.4017,45.2608,"total suspended solids"
"299",12059,2,2001,2003,4,-118.3828,45.275,"total suspended solids"
"300",12141,0,2006,2006,1,-118.081944,45.341944,"total suspended solids"
"301",12181,1,2002,2003,4,-118.533,45.0912,"total suspended solids"
"302",12182,1,2002,2003,2,-118.2985,45.107472,"total suspended solids"
"303",12183,1,2001,2002,2,-118.3307,45.102556,"total suspended solids"
"304",12187,13,2001,2014,47,-123.785583,46.069556,"total suspended solids"
"305",12212,0,2005,2005,3,-120.716583,44.299083,"total suspended solids"
"306",12215,5,2002,2007,2,-123.253833,45.567306,"total suspended solids"
"307",12248,0,2002,2002,4,-123.4275,43.117778,"total suspended solids"
"308",12257,2,2001,2003,3,-119.088583,43.652417,"total suspended solids"
"309",12258,7,2001,2008,5,-117.729878,43.007536,"total suspended solids"
"310",12260,4,2002,2006,3,-117.609444,42.805056,"total suspended solids"
"311",12261,13,2001,2014,19,-116.995278,42.911389,"total suspended solids"
"312",12263,6,2002,2008,3,-117.156389,42.543944,"total suspended solids"
"313",12264,13,2001,2014,15,-118.234111,42.337611,"total suspended solids"
"314",12265,13,2001,2014,17,-118.866583,42.801083,"total suspended solids"
"315",12266,13,2001,2014,16,-119.841944,42.176111,"total suspended solids"
"316",12267,13,2001,2014,11,-119.926667,42.174444,"total suspended solids"
"317",12269,5,2001,2006,4,-118.369333,42.187167,"total suspended solids"
"318",12301,0,2008,2008,9,-123.774778,44.635222,"total suspended solids"
"319",12303,6,2002,2008,52,-122.866778,42.324833,"total suspended solids"
"320",12308,6,2002,2008,65,-122.715722,42.214417,"total suspended solids"
"321",12346,7,2003,2010,2,-121.908139,44.431722,"total suspended solids"
"322",12350,7,2003,2010,2,-123.939889,45.59325,"total suspended solids"
"323",12351,7,2003,2010,2,-123.939889,45.609722,"total suspended solids"
"324",12368,0,2002,2002,7,-123.9155,46.019,"total suspended solids"
"325",12376,6,2002,2008,48,-122.787167,42.253778,"total suspended solids"
"326",12377,6,2002,2008,54,-122.870667,42.332722,"total suspended solids"
"327",12403,0,2013,2013,1,-123.200556,45.118611,"total suspended solids"
"328",12473,1,2001,2002,6,-124.077194,43.113139,"total suspended solids"
"329",12476,1,2001,2002,5,-124.152139,43.052833,"total suspended solids"
"330",12488,0,2001,2001,3,-121.94731,42.133347,"total suspended solids"
"331",12490,0,2003,2003,4,-121.7775,41.996667,"total suspended solids"
"332",12509,0,2007,2007,1,-123.439444,44.138889,"total suspended solids"
"333",12521,0,2007,2007,1,-123.971083,43.963306,"total suspended solids"
"334",12534,6,2002,2008,80,-122.738722,42.222722,"total suspended solids"
"335",12535,6,2002,2008,83,-122.810056,42.279139,"total suspended solids"
"336",12536,6,2002,2008,80,-122.884278,42.36525,"total suspended solids"
"337",12537,6,2002,2008,84,-122.924472,42.394417,"total suspended solids"
"338",12543,0,2004,2004,2,-121.119278,45.450639,"total suspended solids"
"339",12546,0,2005,2005,1,-121.118972,45.450639,"total suspended solids"
"340",12547,0,2005,2005,1,-121.120194,45.450861,"total suspended solids"
"341",12550,0,2012,2012,2,-121.115444,45.451194,"total suspended solids"
"342",12552,11,2002,2013,16,-122.161389,44.174167,"total suspended solids"
"343",12553,12,2001,2013,36,-122.411667,44.752778,"total suspended solids"
"344",12559,12,2001,2013,46,-122.048611,44.693222,"total suspended solids"
"345",12560,0,2002,2002,2,-121.52883,43.77214,"total suspended solids"
"346",12561,10,2002,2012,5,-121.305833,44.079167,"total suspended solids"
"347",12565,0,2002,2002,2,-121.677389,43.520778,"total suspended solids"
"348",12567,0,2002,2002,2,-121.4761,43.7705,"total suspended solids"
"349",12570,0,2002,2002,2,-123.2805,42.942861,"total suspended solids"
"350",12573,0,2002,2002,1,-123.279889,42.942556,"total suspended solids"
"351",12578,0,2002,2002,1,-123.891028,45.206028,"total suspended solids"
"352",12587,3,2002,2005,34,-122.955806,42.426389,"total suspended solids"
"353",12588,3,2002,2005,17,-122.935222,42.3895,"total suspended solids"
"354",12590,13,2001,2014,63,-124.451694,42.916278,"total suspended solids"
"355",12604,0,2006,2006,1,-124.179806,43.57175,"total suspended solids"
"356",12605,0,2009,2009,1,-124.180111,43.571306,"total suspended solids"
"357",12617,6,2004,2010,6,-117.828528,44.817083,"total suspended solids"
"358",12655,4,2001,2005,20,-122.339778,44.155444,"total suspended solids"
"359",12656,3,2002,2005,18,-122.259139,44.157333,"total suspended solids"
"360",12657,3,2002,2005,7,-121.995611,44.35625,"total suspended solids"
"361",12719,1,2007,2008,22,-122.927056,42.362583,"total suspended solids"
"362",12720,0,2002,2002,1,-122.929722,42.374694,"total suspended solids"
"363",12728,1,2007,2008,22,-122.919611,42.362694,"total suspended solids"
"364",12796,4,2002,2006,11,-123.240833,43.443306,"total suspended solids"
"365",12800,4,2002,2006,11,-123.3075,43.421111,"total suspended solids"
"366",12803,4,2002,2006,12,-123.163861,43.409,"total suspended solids"
"367",12807,0,2002,2002,8,-123.324417,43.416333,"total suspended solids"
"368",12832,0,2007,2007,2,-123.857111,45.501278,"total suspended solids"
"369",12838,0,2010,2010,1,-123.884472,45.5145,"total suspended solids"
"370",12841,11,2002,2013,9,-123.855361,45.456944,"total suspended solids"
"371",12849,1,2013,2014,6,-123.769722,45.383611,"total suspended solids"
"372",12866,0,2001,2001,9,-123.874444,45.733333,"total suspended solids"
"373",12868,0,2003,2003,3,-123.168611,44.055556,"total suspended solids"
"374",12869,0,2003,2003,2,-123.154444,44.054444,"total suspended solids"
"375",12911,7,2002,2009,2,-123.355083,42.949972,"total suspended solids"
"376",12951,0,2013,2013,1,-123.534889,45.590194,"total suspended solids"
"377",12962,0,2013,2013,1,-123.603972,45.41575,"total suspended solids"
"378",12974,0,2009,2009,1,-123.205556,46.107222,"total suspended solids"
"379",12975,0,2009,2009,1,-123.207222,46.107222,"total suspended solids"
"380",12987,8,2003,2011,3,-123.8,46.143333,"total suspended solids"
"381",12997,1,2002,2003,2,-118.4174,45.2665,"total suspended solids"
"382",12999,0,2005,2005,1,-117.528658,45.577581,"total suspended solids"
"383",13002,0,2005,2005,1,-117.529097,45.578061,"total suspended solids"
"384",13014,12,2001,2013,12,-118.763167,42.63875,"total suspended solids"
"385",13039,0,2007,2007,2,-123.841806,45.468194,"total suspended solids"
"386",13040,0,2003,2003,1,-121.595556,42.015,"total suspended solids"
"387",13049,4,2006,2010,2,-123.430639,42.741167,"total suspended solids"
"388",13050,0,2002,2002,1,-123.430611,42.738944,"total suspended solids"
"389",13055,0,2006,2006,1,-116.998333,43.902222,"total suspended solids"
"390",13056,0,2006,2006,3,-116.982778,43.875278,"total suspended solids"
"391",13057,0,2006,2006,3,-116.988056,43.875833,"total suspended solids"
"392",13064,0,2006,2006,1,-117.248056,44.354722,"total suspended solids"
"393",13065,0,2006,2006,1,-117.250028,44.357167,"total suspended solids"
"394",13066,0,2006,2006,1,-117.251917,44.357056,"total suspended solids"
"395",13067,0,2006,2006,1,-117.255667,44.356417,"total suspended solids"
"396",13070,13,2001,2014,91,-122.360361,45.299389,"total suspended solids"
"397",13073,0,2006,2006,1,-122.571806,42.546806,"total suspended solids"
"398",13074,0,2006,2006,1,-122.567306,42.547694,"total suspended solids"
"399",13075,0,2006,2006,1,-122.568944,42.547778,"total suspended solids"
"400",13138,10,2002,2012,10,-121.612639,45.569694,"total suspended solids"
"401",13139,0,2012,2012,2,-121.6315,45.56175,"total suspended solids"
"402",13140,0,2012,2012,2,-121.686417,45.556972,"total suspended solids"
"403",13141,11,2001,2012,49,-121.524611,45.663722,"total suspended solids"
"404",13148,0,2012,2012,3,-121.518972,45.699083,"total suspended solids"
"405",13164,0,2006,2006,1,-121.563278,45.509111,"total suspended solids"
"406",13171,0,2005,2005,2,-121.522028,45.62875,"total suspended solids"
"407",13172,0,2005,2005,1,-121.543694,45.623917,"total suspended solids"
"408",13173,0,2005,2005,1,-121.544222,45.631361,"total suspended solids"
"409",13181,2,2004,2006,21,-121.585028,45.563583,"total suspended solids"
"410",13183,0,2006,2006,1,-121.499,45.593806,"total suspended solids"
"411",13184,0,2006,2006,1,-121.499167,45.593417,"total suspended solids"
"412",13195,3,2002,2005,3,-123.5225,45.245861,"total suspended solids"
"413",13216,0,2009,2009,2,-124.007806,43.490444,"total suspended solids"
"414",13229,0,2007,2007,1,-124.156639,42.437861,"total suspended solids"
"415",13253,0,2012,2012,3,-121.5441,45.6432,"total suspended solids"
"416",13295,0,2001,2001,7,-123.8821,45.6916,"total suspended solids"
"417",13296,0,2001,2001,6,-123.9013,45.6886,"total suspended solids"
"418",13298,0,2001,2001,8,-123.930278,45.661111,"total suspended solids"
"419",13368,12,2001,2013,15,-123.771417,45.722333,"total suspended solids"
"420",13372,0,2001,2001,7,-124.1,43.709722,"total suspended solids"
"421",13386,0,2006,2006,4,-124.208889,43.364167,"total suspended solids"
"422",13388,1,2006,2007,26,-124.192778,43.356667,"total suspended solids"
"423",13389,1,2006,2007,25,-124.206944,43.301389,"total suspended solids"
"424",13405,1,2001,2002,7,-124.277278,43.153972,"total suspended solids"
"425",13411,13,2001,2014,47,-123.872306,45.575167,"total suspended solids"
"426",13417,13,2001,2014,41,-123.842583,45.496306,"total suspended solids"
"427",13421,13,2001,2014,50,-123.843111,45.478028,"total suspended solids"
"428",13424,13,2001,2014,45,-123.735611,45.471806,"total suspended solids"
"429",13428,5,2007,2012,36,-123.843889,45.465278,"total suspended solids"
"430",13429,5,2007,2012,35,-123.809167,45.470833,"total suspended solids"
"431",13430,5,2007,2012,39,-123.844444,45.459167,"total suspended solids"
"432",13431,5,2007,2012,32,-123.85853,45.456389,"total suspended solids"
"433",13433,13,2001,2014,58,-123.822778,45.429861,"total suspended solids"
"434",13440,13,2001,2014,62,-123.824722,45.408611,"total suspended solids"
"435",13520,1,2001,2002,3,-124.318333,43.306667,"total suspended solids"
"436",13525,1,2001,2002,6,-124.399444,43.146944,"total suspended solids"
"437",13530,0,2002,2002,2,-124.408333,43.1225,"total suspended solids"
"438",13540,0,2006,2006,6,-124.192222,43.335556,"total suspended solids"
"439",13568,0,2009,2009,3,-124.023333,43.433056,"total suspended solids"
"440",13569,0,2009,2009,3,-124.030556,43.425,"total suspended solids"
"441",13570,13,2001,2014,73,-124.058583,43.405667,"total suspended solids"
"442",13574,13,2001,2014,65,-124.083083,43.363861,"total suspended solids"
"443",13575,1,2001,2002,3,-124.147278,43.288694,"total suspended solids"
"444",13577,1,2001,2002,3,-124.155222,43.3365,"total suspended solids"
"445",13579,0,2002,2002,2,-124.172722,43.349444,"total suspended solids"
"446",13583,6,2001,2007,20,-124.204083,43.325778,"total suspended solids"
"447",13584,1,2001,2002,5,-124.225278,43.340556,"total suspended solids"
"448",13588,1,2001,2002,5,-124.188056,43.466111,"total suspended solids"
"449",13589,1,2001,2002,3,-124.1925,43.462222,"total suspended solids"
"450",13593,1,2001,2002,3,-124.169444,43.432222,"total suspended solids"
"451",13594,1,2001,2002,4,-124.186944,43.4225,"total suspended solids"
"452",13598,1,2001,2002,4,-124.229722,43.400556,"total suspended solids"
"453",13632,0,2002,2002,1,-123.955556,45.890278,"total suspended solids"
"454",13640,0,2001,2001,7,-123.889528,45.709806,"total suspended solids"
"455",13643,0,2001,2001,1,-124.1935,43.462528,"total suspended solids"
"456",13707,0,2001,2001,6,-124.108056,43.705833,"total suspended solids"
"457",13750,1,2002,2003,3,-123.055556,43.711389,"total suspended solids"
"458",13769,1,2002,2003,2,-122.95,43.783333,"total suspended solids"
"459",13781,0,2002,2002,16,-122.346389,42.378056,"total suspended solids"
"460",13782,1,2004,2005,9,-124.505139,42.896361,"total suspended solids"
"461",13945,0,2002,2002,21,-122.154333,43.170278,"total suspended solids"
"462",14008,11,2002,2013,35,-122.150861,45.162722,"total suspended solids"
"463",14018,0,2013,2013,6,-124.118972,43.548111,"total suspended solids"
"464",14042,0,2002,2002,1,-122.85,42.314167,"total suspended solids"
"465",14182,5,2002,2007,2,-124.0585,44.6979,"total suspended solids"
"466",14183,0,2002,2002,1,-124.0595,44.697,"total suspended solids"
"467",14185,0,2002,2002,1,-124.0593,44.6967,"total suspended solids"
"468",14187,5,2002,2007,3,-124.0593,44.6963,"total suspended solids"
"469",14192,0,2002,2002,1,-124.058889,44.696111,"total suspended solids"
"470",14225,0,2011,2011,1,-122.736944,42.2625,"total suspended solids"
"471",14226,0,2011,2011,1,-122.732778,42.268889,"total suspended solids"
"472",14228,0,2011,2011,1,-122.735,42.261944,"total suspended solids"
"473",14240,8,2002,2010,3,-117.778611,44.708056,"total suspended solids"
"474",14241,8,2002,2010,6,-117.783056,44.706111,"total suspended solids"
"475",14242,8,2002,2010,5,-117.784167,44.706111,"total suspended solids"
"476",14243,8,2002,2010,5,-117.784167,44.704722,"total suspended solids"
"477",14245,0,2010,2010,1,-124.350278,43.208056,"total suspended solids"
"478",14246,0,2010,2010,1,-124.350556,43.207778,"total suspended solids"
"479",14247,5,2005,2010,2,-124.356111,43.2025,"total suspended solids"
"480",14248,5,2005,2010,2,-124.350833,43.208889,"total suspended solids"
"481",14249,0,2010,2010,1,-124.351944,43.206389,"total suspended solids"
"482",14254,0,2005,2005,1,-122.878889,45.851389,"total suspended solids"
"483",14255,0,2005,2005,1,-122.886111,45.850833,"total suspended solids"
"484",14256,0,2005,2005,1,-122.88,45.850556,"total suspended solids"
"485",14257,0,2005,2005,1,-122.881389,45.849722,"total suspended solids"
"486",14258,0,2005,2005,1,-122.879167,45.85,"total suspended solids"
"487",14259,0,2005,2005,2,-122.878889,45.849722,"total suspended solids"
"488",14260,0,2005,2005,1,-122.878333,45.849444,"total suspended solids"
"489",14263,0,2005,2005,1,-122.881667,45.85,"total suspended solids"
"490",14268,0,2009,2009,1,-124.316389,43.210278,"total suspended solids"
"491",14314,0,2002,2002,1,-123.081111,44.922778,"total suspended solids"
"492",14320,0,2002,2002,1,-123.078611,44.925833,"total suspended solids"
"493",14321,0,2002,2002,1,-123.078611,44.925833,"total suspended solids"
"494",14322,0,2002,2002,1,-123.078611,44.925833,"total suspended solids"
"495",14393,4,2002,2006,2,-123.94616,46.16115,"total suspended solids"
"496",14421,0,2001,2001,1,-122.948333,44.023056,"total suspended solids"
"497",14422,0,2001,2001,1,-122.945556,44.024167,"total suspended solids"
"498",14423,0,2001,2001,1,-122.945556,44.024167,"total suspended solids"
"499",14434,0,2009,2009,1,-123.244444,44.697778,"total suspended solids"
"500",14460,0,2009,2009,2,-123.227778,44.698611,"total suspended solids"
"501",14463,0,2001,2001,1,-120.201528,45.7175,"total suspended solids"
"502",14509,0,2001,2001,1,-120.287417,45.603194,"total suspended solids"
"503",14510,0,2001,2001,2,-120.295528,45.574944,"total suspended solids"
"504",14511,0,2001,2001,1,-120.299917,45.572111,"total suspended solids"
"505",14734,0,2003,2003,1,-122.774444,42.376111,"total suspended solids"
"506",14741,6,2003,2009,3,-122.770833,42.385556,"total suspended solids"
"507",14743,0,2003,2003,1,-122.773333,42.386667,"total suspended solids"
"508",14804,0,2004,2004,1,-122.806667,45.623056,"total suspended solids"
"509",14805,0,2004,2004,1,-122.81,45.624722,"total suspended solids"
"510",14806,0,2004,2004,1,-122.811389,45.625833,"total suspended solids"
"511",14807,0,2004,2004,1,-122.806389,45.625833,"total suspended solids"
"512",14809,2,2006,2008,2,-119.581389,45.686389,"total suspended solids"
"513",14810,6,2002,2008,4,-119.586111,45.683611,"total suspended solids"
"514",14811,6,2002,2008,3,-119.580833,45.689722,"total suspended solids"
"515",14812,6,2002,2008,4,-119.583333,45.690556,"total suspended solids"
"516",14813,6,2002,2008,3,-119.601111,45.686389,"total suspended solids"
"517",14814,6,2002,2008,4,-119.591389,45.699722,"total suspended solids"
"518",14831,0,2004,2004,1,-120.223333,45.646778,"total suspended solids"
"519",14832,0,2004,2004,2,-120.204972,45.655528,"total suspended solids"
"520",14833,9,2004,2013,4,-120.209722,45.661611,"total suspended solids"
"521",14931,3,2002,2005,2,-122.976667,45.498056,"total suspended solids"
"522",14939,0,2002,2002,1,-122.980278,45.494167,"total suspended solids"
"523",14940,8,2002,2010,4,-122.979444,45.495278,"total suspended solids"
"524",14941,0,2002,2002,1,-122.978889,45.497222,"total suspended solids"
"525",15009,7,2002,2009,3,-124.292222,43.316667,"total suspended solids"
"526",15012,0,2009,2009,1,-124.298056,43.317778,"total suspended solids"
"527",15013,0,2002,2002,1,-124.295833,43.319167,"total suspended solids"
"528",15015,7,2002,2009,3,-124.289167,43.318333,"total suspended solids"
"529",15016,0,2002,2002,1,-124.297778,43.319444,"total suspended solids"
"530",15039,10,2003,2013,2,-123.623611,42.214722,"total suspended solids"
"531",15116,9,2002,2011,2,-121.250278,44.013056,"total suspended solids"
"532",15117,0,2002,2002,1,-121.253889,44.012222,"total suspended solids"
"533",15118,0,2002,2002,1,-121.253056,44.008056,"total suspended solids"
"534",15119,6,2002,2008,3,-122.8725,45.409722,"total suspended solids"
"535",15120,8,2002,2010,4,-122.871944,45.407222,"total suspended solids"
"536",15121,8,2002,2010,4,-122.870833,45.408889,"total suspended solids"
"537",15122,8,2002,2010,4,-122.870278,45.408333,"total suspended solids"
"538",15123,8,2002,2010,5,-122.872778,45.408333,"total suspended solids"
"539",15124,8,2002,2010,4,-122.872778,45.408611,"total suspended solids"
"540",15125,8,2002,2010,5,-122.869167,45.408333,"total suspended solids"
"541",15126,8,2002,2010,5,-122.870833,45.408333,"total suspended solids"
"542",15144,0,2010,2010,1,-117.229167,43.988056,"total suspended solids"
"543",15151,0,2009,2009,1,-117.035,44.011,"total suspended solids"
"544",15169,0,2010,2010,1,-117.01,44.026,"total suspended solids"
"545",15201,4,2009,2013,2,-116.995,44.199,"total suspended solids"
"546",15216,8,2005,2013,3,-116.985,43.895,"total suspended solids"
"547",15221,8,2005,2013,2,-116.993,43.953,"total suspended solids"
"548",15229,0,2011,2011,1,-117.078,44.01,"total suspended solids"
"549",15234,6,2007,2013,6,-117.018,44.019,"total suspended solids"
"550",15281,0,2002,2002,1,-117.233333,43.986111,"total suspended solids"
"551",15327,0,2011,2011,1,-117.035278,44.010833,"total suspended solids"
"552",15328,0,2013,2013,1,-117.004167,44.230556,"total suspended solids"
"553",15329,0,2013,2013,1,-117.004194,43.894444,"total suspended solids"
"554",15330,0,2005,2005,1,-122.699167,45.591667,"total suspended solids"
"555",15331,0,2011,2011,2,-122.700833,45.591944,"total suspended solids"
"556",15361,4,2007,2011,3,-123.396944,42.501389,"total suspended solids"
"557",15387,4,2007,2011,2,-123.398056,42.504722,"total suspended solids"
"558",15446,0,2008,2008,1,-122.580833,45.5625,"total suspended solids"
"559",15450,0,2011,2011,1,-122.583889,45.563056,"total suspended solids"
"560",15459,3,2005,2008,4,-122.973889,45.2825,"total suspended solids"
"561",15499,0,2009,2009,2,-122.387778,45.525556,"total suspended solids"
"562",15500,0,2009,2009,1,-122.387778,45.523056,"total suspended solids"
"563",15508,0,2002,2002,2,-123.105556,44.601944,"total suspended solids"
"564",15509,0,2002,2002,1,-123.106389,44.601667,"total suspended solids"
"565",15517,8,2005,2013,5,-117.155,43.796,"total suspended solids"
"566",15538,4,2005,2009,3,-117.24425,43.643056,"total suspended solids"
"567",15540,8,2005,2013,7,-117.111111,43.780556,"total suspended solids"
"568",15541,6,2007,2013,6,-117.145833,43.786111,"total suspended solids"
"569",15569,5,2008,2013,2,-124.071111,43.690833,"total suspended solids"
"570",15574,5,2008,2013,2,-124.068056,43.688333,"total suspended solids"
"571",15577,5,2008,2013,2,-124.07,43.688333,"total suspended solids"
"572",15578,5,2008,2013,2,-124.071389,43.690556,"total suspended solids"
"573",15596,0,2013,2013,1,-123.246111,45.158944,"total suspended solids"
"574",15598,0,2013,2013,2,-123.246139,45.158917,"total suspended solids"
"575",15607,0,2013,2013,1,-123.243611,45.163611,"total suspended solids"
"576",15611,0,2002,2002,1,-123.246944,45.157778,"total suspended solids"
"577",15612,6,2002,2008,2,-123.246944,45.158056,"total suspended solids"
"578",15615,11,2002,2013,3,-123.242222,45.160556,"total suspended solids"
"579",15617,5,2008,2013,3,-123.25,45.158056,"total suspended solids"
"580",15618,5,2008,2013,2,-123.249722,45.157778,"total suspended solids"
"581",15619,5,2008,2013,2,-123.243333,45.159444,"total suspended solids"
"582",15700,0,2006,2006,1,-123.3876,43.1851,"total suspended solids"
"583",15704,0,2009,2009,1,-123.378611,43.185833,"total suspended solids"
"584",15705,3,2006,2009,3,-123.378611,43.185833,"total suspended solids"
"585",15721,0,2006,2006,1,-123.365278,43.187222,"total suspended solids"
"586",15723,0,2006,2006,1,-123.376111,43.184722,"total suspended solids"
"587",15724,0,2009,2009,1,-123.375833,43.184444,"total suspended solids"
"588",15725,0,2009,2009,1,-123.377778,43.184722,"total suspended solids"
"589",15727,0,2009,2009,1,-123.380278,43.186389,"total suspended solids"
"590",15755,0,2002,2002,2,-122.591167,45.369,"total suspended solids"
"591",15775,0,2013,2013,1,-123.004167,43.957222,"total suspended solids"
"592",15780,0,2013,2013,2,-123.002778,43.958611,"total suspended solids"
"593",15785,7,2006,2013,3,-123.012222,43.954444,"total suspended solids"
"594",15789,4,2009,2013,2,-122.997722,43.957,"total suspended solids"
"595",15796,0,2013,2013,1,-122.994444,43.958333,"total suspended solids"
"596",15801,0,2013,2013,1,-122.991944,43.955556,"total suspended solids"
"597",15834,0,2002,2002,1,-121.445,43.782778,"total suspended solids"
"598",15835,0,2002,2002,1,-121.446389,43.782778,"total suspended solids"
"599",15837,0,2002,2002,1,-121.444861,43.782778,"total suspended solids"
"600",15838,0,2002,2002,2,-121.444722,43.783056,"total suspended solids"
"601",15868,0,2003,2003,1,-122.954722,42.303889,"total suspended solids"
"602",15869,10,2003,2013,3,-122.953889,42.304444,"total suspended solids"
"603",15870,6,2003,2009,4,-122.954167,42.303611,"total suspended solids"
"604",15913,0,2011,2011,1,-122.759167,45.620833,"total suspended solids"
"605",15914,0,2011,2011,1,-122.757778,45.618056,"total suspended solids"
"606",15916,0,2011,2011,1,-122.761389,45.615833,"total suspended solids"
"607",15917,0,2008,2008,2,-122.761389,45.615833,"total suspended solids"
"608",15935,0,2002,2002,1,-122.752333,45.618806,"total suspended solids"
"609",15936,6,2002,2008,2,-122.752333,45.618806,"total suspended solids"
"610",15937,0,2002,2002,1,-122.744167,45.615444,"total suspended solids"
"611",15938,0,2002,2002,1,-122.744167,45.615444,"total suspended solids"
"612",15940,9,2002,2011,2,-122.753889,45.618889,"total suspended solids"
"613",15941,6,2002,2008,3,-122.745306,45.605694,"total suspended solids"
"614",15947,3,2008,2011,2,-122.758611,45.618056,"total suspended solids"
"615",15949,0,2002,2002,1,-122.743889,45.614306,"total suspended solids"
"616",15968,0,2005,2005,1,-123.839722,45.416389,"total suspended solids"
"617",15970,0,2005,2005,1,-123.837222,45.416111,"total suspended solids"
"618",15971,0,2005,2005,1,-123.836111,45.417222,"total suspended solids"
"619",15972,0,2005,2005,1,-123.84,45.408889,"total suspended solids"
"620",15978,0,2005,2005,1,-123.836667,45.416667,"total suspended solids"
"621",15979,0,2005,2005,1,-123.836667,45.416667,"total suspended solids"
"622",15985,0,2005,2005,1,-123.852222,45.415556,"total suspended solids"
"623",15986,0,2005,2005,2,-123.85225,45.415556,"total suspended solids"
"624",15987,0,2005,2005,1,-123.851944,45.411667,"total suspended solids"
"625",15990,0,2005,2005,1,-123.847222,45.416389,"total suspended solids"
"626",16113,0,2009,2009,1,-119.325556,45.784722,"total suspended solids"
"627",16150,0,2009,2009,1,-119.5597,45.8658,"total suspended solids"
"628",16208,0,2010,2010,1,-119.453083,45.851944,"total suspended solids"
"629",16212,0,2009,2009,1,-119.397056,45.846083,"total suspended solids"
"630",16218,0,2010,2010,1,-119.438278,45.837306,"total suspended solids"
"631",16222,0,2009,2009,1,-119.620583,45.848278,"total suspended solids"
"632",16223,0,2009,2009,1,-119.623583,45.807,"total suspended solids"
"633",16224,0,2009,2009,1,-119.380472,45.858,"total suspended solids"
"634",16226,0,2009,2009,1,-119.357778,45.858306,"total suspended solids"
"635",16227,0,2009,2009,1,-119.359806,45.858278,"total suspended solids"
"636",16229,0,2009,2009,1,-119.383139,45.769639,"total suspended solids"
"637",16230,0,2009,2009,1,-119.439139,45.748167,"total suspended solids"
"638",16231,0,2009,2009,1,-119.407139,45.730306,"total suspended solids"
"639",16232,0,2009,2009,1,-119.347833,45.740917,"total suspended solids"
"640",16233,0,2009,2009,1,-119.358056,45.864083,"total suspended solids"
"641",16234,0,2009,2009,1,-119.232611,45.780722,"total suspended solids"
"642",16238,0,2010,2010,1,-119.287139,45.791944,"total suspended solids"
"643",16240,0,2009,2009,1,-119.301722,45.792611,"total suspended solids"
"644",16241,0,2009,2009,1,-119.331167,45.768917,"total suspended solids"
"645",16242,0,2010,2010,1,-119.32175,45.773611,"total suspended solids"
"646",16243,0,2009,2009,1,-119.310139,45.762861,"total suspended solids"
"647",16244,0,2009,2009,1,-119.363583,45.737278,"total suspended solids"
"648",16248,0,2010,2010,1,-119.293472,45.794167,"total suspended solids"
"649",16249,0,2009,2009,1,-119.232583,45.781,"total suspended solids"
"650",16250,0,2009,2009,1,-119.226333,45.782806,"total suspended solids"
"651",16251,0,2009,2009,2,-119.315528,45.797167,"total suspended solids"
"652",16252,0,2009,2009,1,-119.226583,45.782861,"total suspended solids"
"653",16254,0,2009,2009,2,-119.235694,45.82025,"total suspended solids"
"654",16256,0,2010,2010,1,-119.473528,45.897889,"total suspended solids"
"655",16257,0,2010,2010,1,-119.474639,45.898944,"total suspended solids"
"656",16258,0,2010,2010,1,-119.475972,45.900028,"total suspended solids"
"657",16264,0,2010,2010,1,-119.866194,45.795611,"total suspended solids"
"658",16272,10,2003,2013,3,-124.0715,44.3995,"total suspended solids"
"659",16273,10,2003,2013,3,-124.0711,44.4013,"total suspended solids"
"660",16275,10,2003,2013,5,-124.0711,44.3999,"total suspended solids"
"661",16276,10,2003,2013,3,-124.0709,44.3999,"total suspended solids"
"662",16278,10,2003,2013,3,-124.071,44.3998,"total suspended solids"
"663",16280,10,2003,2013,4,-124.0686,44.4024,"total suspended solids"
"664",16677,0,2001,2001,1,-122.856389,45.174167,"total suspended solids"
"665",16696,0,2001,2001,1,-122.859167,45.178611,"total suspended solids"
"666",16697,7,2003,2010,4,-122.855556,45.178056,"total suspended solids"
"667",16699,0,2001,2001,1,-122.859083,45.173389,"total suspended solids"
"668",16701,3,2001,2004,3,-122.860556,45.179444,"total suspended solids"
"669",16705,0,2010,2010,1,-122.856389,45.180833,"total suspended solids"
"670",16708,0,2001,2001,1,-122.858889,45.174444,"total suspended solids"
"671",16709,0,2001,2001,1,-122.858056,45.173333,"total suspended solids"
"672",16718,0,2011,2011,2,-122.7325,42.263611,"total suspended solids"
"673",16727,7,2002,2009,3,-124.318333,43.209167,"total suspended solids"
"674",16732,0,2006,2006,1,-123.112778,44.098333,"total suspended solids"
"675",16733,3,2003,2006,2,-123.106667,44.1075,"total suspended solids"
"676",16734,3,2003,2006,2,-123.106111,44.107778,"total suspended solids"
"677",16737,3,2003,2006,3,-123.108611,44.104167,"total suspended solids"
"678",16738,3,2003,2006,3,-123.111111,44.100556,"total suspended solids"
"679",16739,0,2006,2006,1,-122.771111,42.383333,"total suspended solids"
"680",16740,3,2003,2006,2,-122.771389,42.383611,"total suspended solids"
"681",16742,0,2007,2007,1,-123.3382,43.3371,"total suspended solids"
"682",16743,0,2007,2007,1,-123.337778,43.335833,"total suspended solids"
"683",16754,7,2002,2009,2,-124.297222,43.318333,"total suspended solids"
"684",16757,10,2003,2013,4,-123.624722,42.213611,"total suspended solids"
"685",16758,10,2003,2013,2,-123.625,42.215556,"total suspended solids"
"686",16772,10,2003,2013,3,-122.952778,42.305556,"total suspended solids"
"687",16997,0,2005,2005,1,-120.860444,44.301972,"total suspended solids"
"688",17132,1,2001,2002,3,-124.1205,43.423083,"total suspended solids"
"689",17164,0,2002,2002,1,-122.857361,42.963389,"total suspended solids"
"690",18774,0,2001,2001,1,-124.105528,44.265667,"total suspended solids"
"691",18775,0,2001,2001,1,-123.845472,44.319833,"total suspended solids"
"692",18790,0,2002,2002,1,-123.588667,42.817667,"total suspended solids"
"693",18796,0,2001,2001,1,-123.7928,44.7456,"total suspended solids"
"694",18797,0,2001,2001,1,-123.9003,45.1404,"total suspended solids"
"695",18802,12,2001,2013,5,-123.769111,45.813472,"total suspended solids"
"696",18803,0,2001,2001,1,-123.765083,43.806222,"total suspended solids"
"697",18804,0,2001,2001,1,-124.10825,44.224194,"total suspended solids"
"698",20391,0,2005,2005,1,-124.067333,42.8885,"total suspended solids"
"699",20392,1,2001,2002,4,-124.06725,42.88875,"total suspended solids"
"700",20422,2,2006,2008,2,-119.308333,45.886111,"total suspended solids"
"701",20423,0,2006,2006,2,-119.305278,45.886111,"total suspended solids"
"702",20424,6,2002,2008,3,-119.309722,45.89,"total suspended solids"
"703",20440,0,2001,2001,3,-123.845556,45.695306,"total suspended solids"
"704",20447,6,2005,2011,124,-124.096472,43.595028,"total suspended solids"
"705",20835,0,2003,2003,2,-123.142611,44.054389,"total suspended solids"
"706",20846,0,2003,2003,1,-123.134306,44.059944,"total suspended solids"
"707",20856,0,2002,2002,1,-119.310944,45.861139,"total suspended solids"
"708",21535,3,2011,2014,9,-121.500333,42.462,"total suspended solids"
"709",21636,1,2010,2011,2,-118.0246,45.285383,"total suspended solids"
"710",21790,0,2002,2002,2,-123.979761,44.499656,"total suspended solids"
"711",21791,0,2007,2007,2,-124.105811,44.170708,"total suspended solids"
"712",21792,0,2003,2003,2,-123.92875,44.580669,"total suspended solids"
"713",21797,2,2003,2005,2,-124.185911,42.974633,"total suspended solids"
"714",21799,0,2002,2002,1,-124.029111,42.768633,"total suspended solids"
"715",21800,2,2011,2013,9,-123.55045,45.277942,"total suspended solids"
"716",21804,3,2002,2005,3,-123.621869,45.228936,"total suspended solids"
"717",21805,3,2002,2005,4,-123.830931,45.351989,"total suspended solids"
"718",21806,0,2002,2002,1,-123.822639,45.284822,"total suspended solids"
"719",21811,0,2003,2003,1,-123.51585,45.585806,"total suspended solids"
"720",21818,2,2012,2014,17,-122.845169,44.704356,"total suspended solids"
"721",21822,1,2002,2003,3,-123.238861,42.101917,"total suspended solids"
"722",21835,4,2001,2005,4,-122.101831,44.782844,"total suspended solids"
"723",21839,1,2002,2003,3,-122.889283,43.740583,"total suspended solids"
"724",21841,0,2002,2002,1,-123.125125,45.508128,"total suspended solids"
"725",21842,0,2007,2007,1,-123.851073,44.538726,"total suspended solids"
"726",22368,0,2014,2014,1,-123.7341,45.278697,"total suspended solids"
"727",22369,0,2011,2011,2,-123.706519,45.277064,"total suspended solids"
"728",22375,2,2011,2013,8,-123.603114,45.239361,"total suspended solids"
"729",22383,2,2011,2013,9,-123.580667,45.265833,"total suspended solids"
"730",22394,2,2011,2013,14,-123.818167,45.2765,"total suspended solids"
"731",22569,2,2001,2003,12,-121.464178,43.824022,"total suspended solids"
"732",22571,0,2002,2002,1,-121.464156,43.824003,"total suspended solids"
"733",22572,0,2002,2002,1,-121.464147,43.823897,"total suspended solids"
"734",22668,0,2002,2002,1,-124.238749,43.43694,"total suspended solids"
"735",22672,0,2002,2002,1,-124.241013,43.436491,"total suspended solids"
"736",22673,0,2002,2002,1,-124.24587,43.434834,"total suspended solids"
"737",22676,9,2004,2013,2,-123.426725,43.103019,"total suspended solids"
"738",22677,9,2004,2013,3,-123.426539,43.100265,"total suspended solids"
"739",22678,9,2004,2013,2,-123.426539,43.098648,"total suspended solids"
"740",22679,0,2004,2004,1,-123.426304,43.099508,"total suspended solids"
"741",22680,9,2004,2013,2,-123.426256,43.102881,"total suspended solids"
"742",22683,0,2002,2002,1,-122.744444,45.612222,"total suspended solids"
"743",22684,0,2005,2005,1,-121.136719,45.560133,"total suspended solids"
"744",22687,2,2005,2007,2,-121.130381,45.561053,"total suspended solids"
"745",22692,6,2005,2011,2,-122.699583,45.593611,"total suspended solids"
"746",22699,0,2002,2002,1,-121.251389,44.010556,"total suspended solids"
"747",22700,0,2002,2002,1,-121.258889,44.010278,"total suspended solids"
"748",22701,5,2006,2011,4,-121.446111,43.782778,"total suspended solids"
"749",22702,5,2006,2011,4,-121.445,43.781667,"total suspended solids"
"750",22705,5,2006,2011,3,-121.444722,43.782222,"total suspended solids"
"751",22715,0,2002,2002,1,-122.995,44.900278,"total suspended solids"
"752",22716,7,2002,2009,4,-122.998056,44.901389,"total suspended solids"
"753",22719,7,2002,2009,4,-122.993889,44.897222,"total suspended solids"
"754",22721,6,2003,2009,3,-122.770278,42.386111,"total suspended solids"
"755",22931,9,2002,2011,4,-123.366278,46.031611,"total suspended solids"
"756",22965,0,2005,2005,2,-121.495472,45.651611,"total suspended solids"
"757",22966,0,2005,2005,1,-121.495667,45.651639,"total suspended solids"
"758",22970,0,2005,2005,1,-121.543528,45.635028,"total suspended solids"
"759",22971,0,2005,2005,1,-121.534306,45.628639,"total suspended solids"
"760",22972,0,2005,2005,2,-121.530056,45.627278,"total suspended solids"
"761",22973,0,2005,2005,2,-121.529611,45.627278,"total suspended solids"
"762",22974,0,2005,2005,2,-121.528,45.627278,"total suspended solids"
"763",22978,0,2005,2005,1,-121.518778,45.638889,"total suspended solids"
"764",22985,0,2005,2005,1,-118.84027,45.668152,"total suspended solids"
"765",22986,0,2005,2005,1,-118.84195,45.66786,"total suspended solids"
"766",23026,0,2005,2005,1,-117.913528,45.577083,"total suspended solids"
"767",23038,0,2005,2005,1,-118.83934,45.66825,"total suspended solids"
"768",23070,6,2002,2008,51,-122.851722,42.318083,"total suspended solids"
"769",23160,4,2004,2008,2,-123.098056,43.303056,"total suspended solids"
"770",23161,4,2004,2008,3,-123.100556,43.303056,"total suspended solids"
"771",23162,4,2004,2008,3,-123.100556,43.305,"total suspended solids"
"772",23163,4,2004,2008,2,-123.099444,43.305556,"total suspended solids"
"773",23172,3,2001,2004,5,-122.86916,45.181111,"total suspended solids"
"774",23176,1,2003,2004,2,-122.86,45.181667,"total suspended solids"
"775",23195,0,2013,2013,1,-116.995,44.198333,"total suspended solids"
"776",23196,2,2006,2008,2,-118.116667,45.3525,"total suspended solids"
"777",23197,6,2002,2008,3,-118.121667,45.348333,"total suspended solids"
"778",23198,4,2002,2006,3,-118.121944,45.347778,"total suspended solids"
"779",23202,0,2002,2002,1,-118.121806,45.347917,"total suspended solids"
"780",23242,0,2001,2001,2,-123.95,44.020833,"total suspended solids"
"781",23487,2,2005,2007,15,-118.165106,45.829289,"total suspended solids"
"782",23492,2,2005,2007,23,-118.333181,45.900972,"total suspended solids"
"783",23497,0,2011,2011,3,-118.378722,46,"total suspended solids"
"784",23509,13,2001,2014,20,-123.589979,45.84384,"total suspended solids"
"785",23587,0,2013,2013,3,-123.305285,45.876023,"total suspended solids"
"786",23738,1,2001,2002,3,-122.648483,42.439617,"total suspended solids"
"787",23753,0,2008,2008,4,-124.407222,42.371944,"total suspended solids"
"788",23769,2,2012,2014,21,-122.8045,44.65808,"total suspended solids"
"789",23770,2,2012,2014,18,-122.8549,44.63358,"total suspended solids"
"790",23775,2,2012,2014,18,-122.7979,44.51356,"total suspended solids"
"791",23778,2,2012,2014,15,-122.7676,44.46067,"total suspended solids"
"792",23785,2,2012,2014,17,-122.8588,44.70381,"total suspended solids"
"793",23797,2,2001,2003,13,-122.826317,45.970117,"total suspended solids"
"794",23800,2,2001,2003,14,-123.4242,46.220683,"total suspended solids"
"795",23821,0,2003,2003,1,-123.68697,44.197048,"total suspended solids"
"796",23823,0,2003,2003,1,-123.9838,44.085856,"total suspended solids"
"797",23836,0,2002,2002,1,-123.39559,42.781741,"total suspended solids"
"798",23837,3,2002,2005,2,-123.60948,43.45645,"total suspended solids"
"799",23839,0,2003,2003,1,-123.20991,42.602606,"total suspended solids"
"800",23843,0,2007,2007,1,-123.23909,42.07499,"total suspended solids"
"801",23853,0,2003,2003,1,-123.350797,45.173487,"total suspended solids"
"802",23857,0,2003,2003,1,-122.677977,43.620848,"total suspended solids"
"803",23859,2,2001,2003,18,-123.393163,44.265533,"total suspended solids"
"804",23863,0,2007,2007,2,-123.311606,44.415841,"total suspended solids"
"805",23873,0,2001,2001,4,-123.366286,45.98023,"total suspended solids"
"806",23959,0,2002,2002,2,-124.00586,43.27088,"total suspended solids"
"807",23961,0,2002,2002,2,-124.02177,43.29058,"total suspended solids"
"808",23980,1,2001,2002,4,-124.09378,43.1865,"total suspended solids"
"809",24297,0,2001,2001,6,-123.863198,45.731672,"total suspended solids"
"810",24299,0,2001,2001,4,-123.201595,45.843657,"total suspended solids"
"811",24300,0,2001,2001,4,-123.154787,45.899615,"total suspended solids"
"812",24326,0,2002,2002,4,-123.9115,46.0107,"total suspended solids"
"813",24341,8,2005,2013,5,-117.0573,43.795233,"total suspended solids"
"814",24344,0,2005,2005,1,NA,NA,"total suspended solids"
"815",24364,0,2001,2001,1,-121.493611,43.700556,"total suspended solids"
"816",24366,0,2001,2001,1,-121.498333,43.706389,"total suspended solids"
"817",24368,0,2001,2001,1,-121.496667,43.710556,"total suspended solids"
"818",24373,0,2001,2001,1,-121.464583,43.792833,"total suspended solids"
"819",24374,0,2001,2001,1,-121.464583,43.792389,"total suspended solids"
"820",24375,0,2001,2001,1,-121.463972,43.792694,"total suspended solids"
"821",24377,0,2001,2001,1,-121.458611,43.799722,"total suspended solids"
"822",24382,2,2001,2003,23,-121.464052,43.792862,"total suspended solids"
"823",24388,0,2001,2001,7,-123.8804,45.7012,"total suspended solids"
"824",24488,5,2002,2007,4,-123.93222,44.60538,"total suspended solids"
"825",24489,9,2002,2011,5,-123.93369,44.60559,"total suspended solids"
"826",24490,2,2002,2004,2,-123.92893,44.60188,"total suspended solids"
"827",24491,0,2002,2002,1,-123.9316,44.6049,"total suspended solids"
"828",24492,0,2002,2002,2,-123.92233,44.60043,"total suspended solids"
"829",24504,0,2001,2001,1,-121.47622,43.70785,"total suspended solids"
"830",24505,0,2001,2001,2,-121.47728,43.70758,"total suspended solids"
"831",24565,1,2002,2003,44,-121.08492,45.60641,"total suspended solids"
"832",24566,1,2002,2003,40,-121.05479,45.63068,"total suspended solids"
"833",24567,1,2002,2003,34,-121.21772,45.43333,"total suspended solids"
"834",24568,1,2002,2003,37,-121.2182,45.43366,"total suspended solids"
"835",24569,1,2002,2003,38,-121.04485,45.49942,"total suspended solids"
"836",24574,2,2012,2014,16,-122.946444,44.735333,"total suspended solids"
"837",24578,1,2002,2003,6,-121.494631,43.730308,"total suspended solids"
"838",24580,2,2001,2003,9,-121.494496,43.730231,"total suspended solids"
"839",24581,2,2001,2003,13,-121.494503,43.730204,"total suspended solids"
"840",24582,1,2002,2003,10,-121.464119,43.792859,"total suspended solids"
"841",24585,2,2001,2003,13,-121.463913,43.792493,"total suspended solids"
"842",24586,2,2001,2003,18,-121.463982,43.793019,"total suspended solids"
"843",24597,2,2001,2003,9,-121.459773,43.794534,"total suspended solids"
"844",24598,2,2001,2003,12,-121.459472,43.794677,"total suspended solids"
"845",24599,2,2001,2003,12,-121.465437,43.821942,"total suspended solids"
"846",24600,1,2002,2003,5,-121.465284,43.821938,"total suspended solids"
"847",24601,2,2001,2003,11,-121.465281,43.821642,"total suspended solids"
"848",24607,2,2001,2003,16,-121.521171,43.70068,"total suspended solids"
"849",24608,2,2001,2003,12,-121.477183,43.707738,"total suspended solids"
"850",24609,2,2001,2003,8,-121.478097,43.715172,"total suspended solids"
"851",24610,0,2002,2002,1,-121.519353,43.709913,"total suspended solids"
"852",24611,2,2001,2003,21,-121.516251,43.712803,"total suspended solids"
"853",24612,2,2001,2003,11,-121.45929,43.830933,"total suspended solids"
"854",24613,2,2001,2003,10,-121.499226,43.743467,"total suspended solids"
"855",24614,1,2001,2002,4,-121.497529,43.702649,"total suspended solids"
"856",24615,1,2002,2003,6,-121.461357,43.790607,"total suspended solids"
"857",24617,2,2001,2003,13,-121.459385,43.831098,"total suspended solids"
"858",24618,2,2001,2003,16,-121.459356,43.831066,"total suspended solids"
"859",24619,2,2001,2003,19,-121.459337,43.831026,"total suspended solids"
"860",24621,0,2001,2001,1,-121.569532,43.639586,"total suspended solids"
"861",24622,0,2001,2001,1,-121.569551,43.640423,"total suspended solids"
"862",24623,0,2001,2001,1,-121.569551,43.64045,"total suspended solids"
"863",24625,2,2001,2003,15,-121.568061,43.640232,"total suspended solids"
"864",24627,2,2001,2003,15,-121.568106,43.640269,"total suspended solids"
"865",24628,2,2001,2003,14,-121.568306,43.640127,"total suspended solids"
"866",24632,1,2001,2002,3,-121.547207,43.701535,"total suspended solids"
"867",24633,2,2002,2004,13,-121.547263,43.701555,"total suspended solids"
"868",24634,3,2001,2004,22,-121.547058,43.701781,"total suspended solids"
"869",24635,0,2001,2001,2,-121.522216,43.700471,"total suspended solids"
"870",24636,0,2001,2001,1,-121.522209,43.701174,"total suspended solids"
"871",24637,0,2001,2001,1,-121.52121,43.701268,"total suspended solids"
"872",24639,2,2001,2003,16,-121.521416,43.700597,"total suspended solids"
"873",24641,2,2001,2003,16,-121.521494,43.700592,"total suspended solids"
"874",24642,2,2001,2003,15,-121.521424,43.700947,"total suspended solids"
"875",24643,3,2001,2004,20,-121.519032,43.709907,"total suspended solids"
"876",24644,2,2002,2004,20,-121.519575,43.709905,"total suspended solids"
"877",24645,2,2002,2004,14,-121.516173,43.712769,"total suspended solids"
"878",24646,3,2001,2004,19,-121.517581,43.712739,"total suspended solids"
"879",24648,0,2001,2001,1,-121.460742,43.790434,"total suspended solids"
"880",24649,0,2001,2001,2,-121.459396,43.831094,"total suspended solids"
"881",24655,2,2001,2003,17,-121.497325,43.702543,"total suspended solids"
"882",24656,2,2001,2003,16,-121.49733,43.702518,"total suspended solids"
"883",24657,2,2001,2003,30,-121.497359,43.702491,"total suspended solids"
"884",24659,2,2001,2003,13,-121.476727,43.707493,"total suspended solids"
"885",24663,0,2001,2001,1,-121.478113,43.715387,"total suspended solids"
"886",24664,2,2001,2003,12,-121.477723,43.714997,"total suspended solids"
"887",24665,2,2001,2003,15,-121.495002,43.729247,"total suspended solids"
"888",24666,2,2001,2003,10,-121.49539,43.729411,"total suspended solids"
"889",24667,2,2001,2003,10,-121.495338,43.729463,"total suspended solids"
"890",24668,2,2001,2003,9,-121.4598,43.794643,"total suspended solids"
"891",24673,2,2001,2003,13,-121.460764,43.79042,"total suspended solids"
"892",24674,2,2001,2003,14,-121.4608,43.790426,"total suspended solids"
"893",24675,2,2001,2003,18,-121.460854,43.790442,"total suspended solids"
"894",24676,10,2002,2012,4,-121.80452,42.17722,"total suspended solids"
"895",24678,10,2002,2012,5,-121.80387,42.17511,"total suspended solids"
"896",24679,6,2006,2012,3,-121.80475,42.1743,"total suspended solids"
"897",24682,0,2001,2001,2,-121.497326,43.702575,"total suspended solids"
"898",24683,2,2001,2003,14,-121.464178,43.824022,"total suspended solids"
"899",24690,2,2001,2003,12,-121.500523,43.742338,"total suspended solids"
"900",24692,2,2001,2003,14,-121.500523,43.742372,"total suspended solids"
"901",10150,0,2002,2002,3,-123.266111,44.041111,"field  turbidity"
"902",10151,2,2001,2003,23,-123.268611,44.005278,"field  turbidity"
"903",10332,11,2001,2012,70,-122.7475,45.577944,"field  turbidity"
"904",10339,11,2001,2012,92,-122.690722,45.300333,"field  turbidity"
"905",10342,10,2001,2011,21,-122.942361,45.267639,"field  turbidity"
"906",10344,11,2001,2012,118,-123.044306,45.090583,"field  turbidity"
"907",10346,0,2005,2005,4,-123.041056,44.947167,"field  turbidity"
"908",10350,11,2001,2012,153,-123.105778,44.639722,"field  turbidity"
"909",10351,0,2010,2010,1,-123.163611,44.638056,"field  turbidity"
"910",10352,11,2001,2012,198,-123.255417,44.565528,"field  turbidity"
"911",10355,11,2001,2012,118,-123.173667,44.267167,"field  turbidity"
"912",10359,11,2001,2012,59,-123.02675,44.045611,"field  turbidity"
"913",10360,2,2008,2010,6,-122.600222,45.373528,"field  turbidity"
"914",10362,5,2006,2011,65,-122.738028,45.259861,"field  turbidity"
"915",10363,11,2001,2012,159,-123.071583,45.223639,"field  turbidity"
"916",10364,8,2003,2011,66,-123.1463,44.928,"field  turbidity"
"917",10366,11,2001,2012,69,-122.923556,44.636194,"field  turbidity"
"918",10372,5,2006,2011,64,-123.111667,44.635556,"field  turbidity"
"919",10373,11,2001,2012,73,-123.263639,44.556639,"field  turbidity"
"920",10375,0,2002,2002,4,-123.294722,44.313028,"field  turbidity"
"921",10376,11,2001,2012,130,-123.046194,44.112722,"field  turbidity"
"922",10379,1,2010,2011,5,-122.9655,43.981,"field  turbidity"
"923",10386,11,2001,2012,125,-122.905278,43.998194,"field  turbidity"
"924",10391,11,2001,2012,64,-123.9135,44.7643,"field  turbidity"
"925",10392,8,2001,2009,25,-123.852139,44.030139,"field  turbidity"
"926",10393,11,2001,2012,68,-124.136694,43.078528,"field  turbidity"
"927",10398,0,2003,2003,1,-116.999361,43.866639,"field  turbidity"
"928",10401,1,2005,2006,6,-119.146514,44.415989,"field  turbidity"
"929",10404,11,2001,2012,81,-119.035389,45.677444,"field  turbidity"
"930",10405,0,2005,2005,2,-118.875611,45.65775,"field  turbidity"
"931",10406,11,2001,2012,70,-118.7585,45.674806,"field  turbidity"
"932",10407,11,2001,2012,67,-116.972222,44.05675,"field  turbidity"
"933",10408,0,2006,2006,4,-117.141361,44.000222,"field  turbidity"
"934",10410,11,2001,2012,60,-117.719639,45.621306,"field  turbidity"
"935",10411,11,2001,2012,73,-120.910167,45.630222,"field  turbidity"
"936",10413,3,2005,2008,7,-124.327472,42.481639,"field  turbidity"
"937",10414,11,2001,2012,94,-124.292167,42.503667,"field  turbidity"
"938",10418,11,2001,2012,73,-123.487278,42.496833,"field  turbidity"
"939",10421,11,2001,2012,76,-123.089389,42.432694,"field  turbidity"
"940",10423,11,2001,2012,92,-122.841583,42.525333,"field  turbidity"
"941",10425,5,2002,2007,10,-124.063489,42.548747,"field  turbidity"
"942",10428,11,2001,2012,61,-123.455833,42.3975,"field  turbidity"
"943",10430,6,2002,2008,64,-122.898833,42.38225,"field  turbidity"
"944",10433,6,2002,2008,61,-122.818333,42.280278,"field  turbidity"
"945",10434,9,2002,2011,63,-122.744944,42.224417,"field  turbidity"
"946",10437,11,2001,2012,63,-123.565833,43.631861,"field  turbidity"
"947",10440,0,2002,2002,4,-123.467,43.366167,"field  turbidity"
"948",10441,11,2001,2012,68,-123.563444,43.635139,"field  turbidity"
"949",10442,11,2001,2012,66,-123.411056,43.241778,"field  turbidity"
"950",10443,11,2001,2012,64,-123.397944,43.133889,"field  turbidity"
"951",10444,0,2002,2002,2,-123.294889,43.025444,"field  turbidity"
"952",10445,4,2002,2006,8,-123.284667,42.944056,"field  turbidity"
"953",10451,11,2001,2012,52,-123.409222,43.271861,"field  turbidity"
"954",10456,11,2001,2012,70,-122.756278,45.386139,"field  turbidity"
"955",10458,11,2001,2012,63,-122.893667,45.409389,"field  turbidity"
"956",10459,11,2001,2012,64,-122.919778,45.444415,"field  turbidity"
"957",10461,11,2001,2012,64,-122.950556,45.490056,"field  turbidity"
"958",10466,0,2008,2008,1,-123.124056,45.477639,"field  turbidity"
"959",10469,11,2001,2012,76,-122.752778,45.415472,"field  turbidity"
"960",10480,11,2001,2012,59,-122.89875,45.520861,"field  turbidity"
"961",10506,11,2001,2012,54,-121.227806,44.761167,"field  turbidity"
"962",10508,11,2001,2012,65,-121.293778,44.359917,"field  turbidity"
"963",10509,1,2001,2002,7,-121.253861,44.268139,"field  turbidity"
"964",10511,11,2001,2012,60,-121.320444,44.060083,"field  turbidity"
"965",10517,11,2001,2012,66,-121.080694,44.348694,"field  turbidity"
"966",10521,11,2001,2012,57,-123.9251,45.952,"field  turbidity"
"967",10523,11,2001,2012,134,-123.8902,45.2071,"field  turbidity"
"968",10526,0,2006,2006,3,-124.015139,44.967833,"field  turbidity"
"969",10533,11,2001,2012,74,-124.481417,42.81675,"field  turbidity"
"970",10535,1,2008,2009,8,-124.352306,42.277056,"field  turbidity"
"971",10537,11,2001,2012,72,-124.186139,42.007139,"field  turbidity"
"972",10555,11,2001,2012,122,-123.041528,44.946111,"field  turbidity"
"973",10582,0,2009,2009,2,-124.012583,44.92675,"field  turbidity"
"974",10585,1,2007,2008,14,-123.751139,44.376111,"field  turbidity"
"975",10588,0,2008,2008,2,-123.875583,44.534556,"field  turbidity"
"976",10596,11,2001,2012,90,-124.192528,43.173778,"field  turbidity"
"977",10599,6,2002,2008,12,-124.061667,42.58725,"field  turbidity"
"978",10602,11,2001,2012,86,-122.855028,42.455444,"field  turbidity"
"979",10607,0,2006,2006,6,-122.766694,45.652167,"field  turbidity"
"980",10611,11,2001,2012,117,-122.669889,45.513306,"field  turbidity"
"981",10616,11,2001,2012,59,-122.738861,45.645639,"field  turbidity"
"982",10623,5,2006,2011,66,-122.640694,45.441917,"field  turbidity"
"983",10637,11,2001,2012,135,-122.709222,45.267667,"field  turbidity"
"984",10638,0,2008,2008,1,-122.537028,45.162694,"field  turbidity"
"985",10640,11,2001,2012,68,-122.792528,45.150361,"field  turbidity"
"986",10646,6,2005,2011,56,-122.824194,45.006583,"field  turbidity"
"987",10647,0,2006,2006,4,-122.767528,44.989889,"field  turbidity"
"988",10648,0,2005,2005,5,-122.997111,45.229778,"field  turbidity"
"989",10652,0,2003,2003,7,-123.02275,44.945222,"field  turbidity"
"990",10655,1,2002,2003,14,-123.037944,44.936111,"field  turbidity"
"991",10656,0,2005,2005,3,-123.114583,44.929472,"field  turbidity"
"992",10658,9,2002,2011,69,-123.161389,44.730361,"field  turbidity"
"993",10659,3,2002,2005,11,-123.235333,44.782778,"field  turbidity"
"994",10661,0,2002,2002,3,-123.355056,44.060444,"field  turbidity"
"995",10662,11,2001,2012,87,-122.831222,44.055278,"field  turbidity"
"996",10663,11,2001,2012,60,-122.959333,44.092306,"field  turbidity"
"997",10674,11,2001,2012,60,-122.375444,45.5385,"field  turbidity"
"998",10679,0,2008,2008,1,-121.631111,45.604917,"field  turbidity"
"999",10681,1,2008,2009,23,-121.632861,45.604361,"field  turbidity"
"1000",10684,1,2001,2002,4,-121.410667,43.930806,"field  turbidity"
"1001",10686,11,2001,2012,64,-121.451194,43.863361,"field  turbidity"
"1002",10687,1,2001,2002,4,-121.4981,43.8174,"field  turbidity"
"1003",10688,11,2001,2012,61,-121.607028,43.743417,"field  turbidity"
"1004",10689,1,2001,2002,4,-121.688722,43.684417,"field  turbidity"
"1005",10690,10,2002,2012,40,-121.619528,44.5565,"field  turbidity"
"1006",10694,0,2002,2002,1,-121.463333,43.873028,"field  turbidity"
"1007",10696,11,2001,2012,55,-121.4513,43.8204,"field  turbidity"
"1008",10697,1,2001,2002,4,-121.500167,43.692306,"field  turbidity"
"1009",10698,1,2001,2002,4,-121.572028,43.661806,"field  turbidity"
"1010",10699,1,2001,2002,4,-121.6516,43.5248,"field  turbidity"
"1011",10703,8,2001,2009,8,-121.696889,43.463472,"field  turbidity"
"1012",10705,1,2001,2002,3,-121.5315,43.7943,"field  turbidity"
"1013",10708,0,2011,2011,3,-120.023139,45.739806,"field  turbidity"
"1014",10719,11,2001,2012,61,-117.909278,45.566889,"field  turbidity"
"1015",10720,11,2001,2012,67,-118.235556,45.342111,"field  turbidity"
"1016",10724,11,2001,2012,62,-117.4675,44.818333,"field  turbidity"
"1017",10725,0,2007,2007,5,-117.831889,44.737139,"field  turbidity"
"1018",10727,0,2006,2006,3,-117.363972,43.939472,"field  turbidity"
"1019",10728,11,2001,2012,64,-117.229167,43.988056,"field  turbidity"
"1020",10729,11,2001,2012,65,-117.054333,43.783861,"field  turbidity"
"1021",10730,4,2008,2012,5,-117.622806,42.840694,"field  turbidity"
"1022",10741,11,2001,2012,8,-119.901056,42.407139,"field  turbidity"
"1023",10743,2,2001,2003,6,-120.545028,42.696083,"field  turbidity"
"1024",10751,7,2001,2008,5,-120.389389,42.19325,"field  turbidity"
"1025",10758,0,2003,2003,5,-121.560417,42.010278,"field  turbidity"
"1026",10759,11,2001,2012,65,-121.622667,42.040417,"field  turbidity"
"1027",10762,0,2003,2003,3,-121.757694,42.154,"field  turbidity"
"1028",10763,11,2001,2012,72,-121.840722,42.079917,"field  turbidity"
"1029",10764,11,2001,2012,55,-122.059917,42.086917,"field  turbidity"
"1030",10765,11,2001,2012,71,-121.927778,42.128056,"field  turbidity"
"1031",10767,0,2002,2002,3,-121.797722,42.174944,"field  turbidity"
"1032",10768,11,2001,2012,74,-121.788361,42.218778,"field  turbidity"
"1033",10770,11,2001,2012,59,-121.916194,42.514611,"field  turbidity"
"1034",10775,8,2003,2011,55,-123.012861,44.715389,"field  turbidity"
"1035",10792,11,2001,2012,67,-122.971111,44.708722,"field  turbidity"
"1036",10801,11,2001,2012,71,-122.709083,45.563806,"field  turbidity"
"1037",10802,6,2005,2011,72,-122.699972,45.558556,"field  turbidity"
"1038",10811,0,2003,2003,5,-123.915833,46.168583,"field  turbidity"
"1039",10812,11,2001,2012,66,-123.924361,46.148972,"field  turbidity"
"1040",10813,0,2003,2003,3,-123.9089,46.0944,"field  turbidity"
"1041",10817,11,2001,2012,65,-123.839972,46.075028,"field  turbidity"
"1042",10821,1,2010,2011,7,-122.763889,45.584722,"field  turbidity"
"1043",10827,1,2002,2003,4,-122.665778,45.473194,"field  turbidity"
"1044",10833,1,2010,2011,4,-122.640194,45.340472,"field  turbidity"
"1045",10853,1,2001,2002,8,-122.568333,45.467778,"field  turbidity"
"1046",10868,2,2009,2011,26,-122.353306,45.432722,"field  turbidity"
"1047",10873,5,2006,2011,59,-122.598667,45.364667,"field  turbidity"
"1048",10886,0,2005,2005,5,-122.756472,45.233639,"field  turbidity"
"1049",10896,5,2002,2007,56,-122.7804,45.1477,"field  turbidity"
"1050",10898,0,2005,2005,1,-122.671083,45.047278,"field  turbidity"
"1051",10899,9,2002,2011,132,-122.8225,45.1004,"field  turbidity"
"1052",10909,0,2008,2008,3,-123.842194,44.731917,"field  turbidity"
"1053",10917,11,2001,2012,140,-122.748972,45.233806,"field  turbidity"
"1054",10924,4,2007,2011,45,-123.108389,45.240194,"field  turbidity"
"1055",10929,11,2001,2012,115,-123.17417,45.25194,"field  turbidity"
"1056",10937,1,2005,2006,12,-123.229722,45.230194,"field  turbidity"
"1057",10948,11,2001,2012,75,-123.206917,45.168667,"field  turbidity"
"1058",10949,1,2008,2009,12,-123.263222,45.107917,"field  turbidity"
"1059",10952,1,2008,2009,11,-123.4975,45.052167,"field  turbidity"
"1060",10953,1,2008,2009,11,-123.56125,45.06475,"field  turbidity"
"1061",10957,0,2008,2008,4,-123.211806,45.116167,"field  turbidity"
"1062",10958,0,2003,2003,5,-123.265861,45.052667,"field  turbidity"
"1063",10959,0,2008,2008,2,-123.249222,45.084583,"field  turbidity"
"1064",10963,3,2006,2009,25,-123.276333,45.126278,"field  turbidity"
"1065",10967,3,2006,2009,25,-123.438611,45.079389,"field  turbidity"
"1066",10969,0,2006,2006,1,-123.486,45.079083,"field  turbidity"
"1067",10982,0,2007,2007,1,-123.879972,44.063,"field  turbidity"
"1068",10983,1,2007,2008,11,-123.658361,43.984639,"field  turbidity"
"1069",10984,1,2007,2008,10,-123.640028,43.929833,"field  turbidity"
"1070",10989,1,2007,2008,13,-123.608139,43.998694,"field  turbidity"
"1071",10990,1,2007,2008,11,-123.6205,43.954889,"field  turbidity"
"1072",10991,0,2003,2003,2,-122.967528,43.789139,"field  turbidity"
"1073",10993,0,2003,2003,2,-122.836917,43.695861,"field  turbidity"
"1074",10996,11,2001,2012,95,-123.459528,43.366361,"field  turbidity"
"1075",10997,11,2001,2012,66,-123.33575,42.943861,"field  turbidity"
"1076",11001,1,2002,2003,54,-123.9138,45.1528,"field  turbidity"
"1077",11003,3,2002,2005,51,-123.86088,45.229944,"field  turbidity"
"1078",11017,11,2001,2012,63,-119.637694,44.756,"field  turbidity"
"1079",11020,11,2001,2012,63,-119.531222,44.465639,"field  turbidity"
"1080",11043,11,2001,2012,58,-117.268861,43.967306,"field  turbidity"
"1081",11044,0,2006,2006,3,-117.603722,43.854389,"field  turbidity"
"1082",11047,9,2003,2012,8,-118.331778,43.783778,"field  turbidity"
"1083",11050,1,2011,2012,4,-117.518556,42.904917,"field  turbidity"
"1084",11051,11,2001,2012,129,-122.937722,42.404722,"field  turbidity"
"1085",11054,5,2006,2011,67,-123.272944,44.556056,"field  turbidity"
"1086",11094,1,2003,2004,4,-123.617667,42.271861,"field  turbidity"
"1087",11096,0,2003,2003,2,-123.457972,42.138944,"field  turbidity"
"1088",11111,0,2002,2002,6,-123.46775,44.681778,"field  turbidity"
"1089",11113,0,2002,2002,5,-123.180833,44.724889,"field  turbidity"
"1090",11114,0,2002,2002,7,-123.2915,44.797194,"field  turbidity"
"1091",11118,0,2002,2002,2,-123.386833,44.847944,"field  turbidity"
"1092",11123,6,2002,2008,93,-122.937306,42.403972,"field  turbidity"
"1093",11125,1,2007,2008,28,-122.924778,42.3895,"field  turbidity"
"1094",11128,6,2002,2008,100,-122.844667,42.314667,"field  turbidity"
"1095",11130,6,2002,2008,94,-122.779056,42.245556,"field  turbidity"
"1096",11133,6,2002,2008,97,-122.652139,42.185472,"field  turbidity"
"1097",11137,2,2001,2003,27,-123.285528,44.248333,"field  turbidity"
"1098",11138,2,2001,2003,26,-123.291417,44.216056,"field  turbidity"
"1099",11140,11,2001,2012,95,-123.294444,44.342861,"field  turbidity"
"1100",11142,0,2002,2002,5,-123.301639,44.118472,"field  turbidity"
"1101",11144,0,2002,2002,1,-123.426861,44.148111,"field  turbidity"
"1102",11148,0,2002,2002,3,-123.306083,43.99175,"field  turbidity"
"1103",11150,0,2002,2002,3,-123.261389,44.005,"field  turbidity"
"1104",11178,0,2002,2002,1,-121.777333,42.216833,"field  turbidity"
"1105",11180,11,2001,2012,77,-123.127472,44.620222,"field  turbidity"
"1106",11182,9,2003,2012,12,-123.107472,44.504611,"field  turbidity"
"1107",11188,0,2003,2003,6,-123.112306,44.603556,"field  turbidity"
"1108",11201,11,2001,2012,79,-122.753056,45.6105,"field  turbidity"
"1109",11226,0,2002,2002,6,-123.842806,45.902083,"field  turbidity"
"1110",11233,11,2001,2012,57,-122.583139,45.378722,"field  turbidity"
"1111",11240,2,2006,2008,16,-121.547639,45.654806,"field  turbidity"
"1112",11241,11,2001,2012,211,-123.944972,45.023417,"field  turbidity"
"1113",11246,0,2008,2008,3,-123.790917,44.742722,"field  turbidity"
"1114",11262,2,2007,2009,19,-123.941972,44.405306,"field  turbidity"
"1115",11263,11,2001,2012,85,-123.831,44.382694,"field  turbidity"
"1116",11275,11,2001,2012,141,-122.985111,44.010028,"field  turbidity"
"1117",11278,0,2003,2003,2,-123.049139,43.718028,"field  turbidity"
"1118",11292,0,2011,2011,2,-123.183639,44.853889,"field  turbidity"
"1119",11304,3,2001,2004,9,-123.337306,43.658306,"field  turbidity"
"1120",11305,3,2001,2004,9,-123.316139,43.660361,"field  turbidity"
"1121",11306,4,2001,2005,9,-123.279333,43.604222,"field  turbidity"
"1122",11309,1,2004,2005,4,-123.301917,43.425472,"field  turbidity"
"1123",11310,0,2002,2002,12,-123.341361,43.2135,"field  turbidity"
"1124",11316,0,2002,2002,3,-123.294944,43.022944,"field  turbidity"
"1125",11321,11,2001,2012,72,-122.64225,45.447167,"field  turbidity"
"1126",11323,1,2001,2002,6,-122.616111,45.461667,"field  turbidity"
"1127",11326,1,2001,2002,7,-122.467778,45.486111,"field  turbidity"
"1128",11373,0,2003,2003,1,-123.159528,42.533139,"field  turbidity"
"1129",11375,0,2011,2011,3,-122.698944,42.659361,"field  turbidity"
"1130",11386,11,2001,2012,60,-120.468639,45.476861,"field  turbidity"
"1131",11412,1,2007,2008,7,-121.561389,45.499722,"field  turbidity"
"1132",11428,0,2001,2001,9,-123.843083,45.768361,"field  turbidity"
"1133",11434,11,2001,2012,72,-123.197583,46.102028,"field  turbidity"
"1134",11457,11,2001,2012,50,-117.729944,45.619556,"field  turbidity"
"1135",11476,11,2001,2012,106,-123.834778,44.657667,"field  turbidity"
"1136",11477,11,2001,2012,72,-120.541139,44.172556,"field  turbidity"
"1137",11478,11,2001,2012,88,-120.002694,44.792417,"field  turbidity"
"1138",11479,11,2001,2012,68,-119.470494,44.466331,"field  turbidity"
"1139",11480,11,2001,2012,71,-117.507583,43.910333,"field  turbidity"
"1140",11482,11,2001,2012,69,-123.68675,42.238389,"field  turbidity"
"1141",11483,11,2001,2012,57,-124.185889,42.123722,"field  turbidity"
"1142",11484,11,2001,2012,78,-123.21575,42.970944,"field  turbidity"
"1143",11485,11,2001,2012,76,-124.113167,43.032944,"field  turbidity"
"1144",11486,11,2001,2012,94,-124.149333,43.008528,"field  turbidity"
"1145",11489,11,2001,2012,65,-119.331944,45.835694,"field  turbidity"
"1146",11490,11,2001,2012,96,-117.826667,44.781944,"field  turbidity"
"1147",11491,6,2006,2012,49,-123.861972,43.788778,"field  turbidity"
"1148",11493,11,2001,2012,91,-124.395556,42.272222,"field  turbidity"
"1149",11494,11,2001,2012,63,-117.251947,44.356872,"field  turbidity"
"1150",11505,3,2006,2009,38,-123.199583,45.152722,"field  turbidity"
"1151",11506,6,2002,2008,60,-122.775333,42.245472,"field  turbidity"
"1152",11514,4,2005,2009,61,-122.783333,45.095333,"field  turbidity"
"1153",11515,4,2005,2009,67,-122.787222,45.088222,"field  turbidity"
"1154",11516,1,2010,2011,12,-122.785972,45.086028,"field  turbidity"
"1155",11517,0,2005,2005,1,-122.75625,45.086028,"field  turbidity"
"1156",11518,0,2005,2005,1,-122.762361,45.075333,"field  turbidity"
"1157",11521,11,2001,2012,58,-117.962611,45.349722,"field  turbidity"
"1158",11522,11,2001,2012,81,-123.365556,43.217778,"field  turbidity"
"1159",11523,6,2002,2008,56,-122.709861,42.215139,"field  turbidity"
"1160",11535,5,2002,2007,31,-122.842361,45.009694,"field  turbidity"
"1161",11543,0,2005,2005,1,-118.838861,45.668556,"field  turbidity"
"1162",11545,0,2002,2002,1,-123.395722,43.211056,"field  turbidity"
"1163",11558,0,2002,2002,2,-121.769222,42.197278,"field  turbidity"
"1164",11571,6,2004,2010,17,-124.105972,43.071667,"field  turbidity"
"1165",11573,6,2004,2010,12,-124.345778,43.135056,"field  turbidity"
"1166",11574,6,2004,2010,13,-124.201,43.179444,"field  turbidity"
"1167",11586,0,2008,2008,2,-117.231772,45.397994,"field  turbidity"
"1168",11587,0,2008,2008,1,-117.232644,45.398289,"field  turbidity"
"1169",11598,0,2003,2003,7,-121.790667,42.178444,"field  turbidity"
"1170",11600,0,2002,2002,2,-121.781694,42.192389,"field  turbidity"
"1171",11614,6,2002,2008,58,-122.651361,42.193083,"field  turbidity"
"1172",11626,7,2001,2008,23,-122.402278,45.473056,"field  turbidity"
"1173",11692,6,2004,2010,11,-124.185889,43.096472,"field  turbidity"
"1174",11698,0,2007,2007,5,-124.189139,43.124528,"field  turbidity"
"1175",11704,0,2007,2007,5,-124.222139,43.177139,"field  turbidity"
"1176",11721,6,2004,2010,12,-124.357167,43.164833,"field  turbidity"
"1177",11724,0,2007,2007,2,-124.146611,43.06975,"field  turbidity"
"1178",11725,0,2007,2007,2,-124.193667,43.173583,"field  turbidity"
"1179",11768,6,2004,2010,13,-124.289528,43.116111,"field  turbidity"
"1180",11778,1,2005,2006,7,-120.793333,44.109722,"field  turbidity"
"1181",11783,0,2010,2010,1,-123.186583,45.855056,"field  turbidity"
"1182",11787,0,2001,2001,4,-123.189194,45.855556,"field  turbidity"
"1183",11823,0,2004,2004,5,-122.802667,45.008417,"field  turbidity"
"1184",11825,0,2004,2004,3,-122.802722,45.008972,"field  turbidity"
"1185",11826,0,2009,2009,5,-120.599778,45.702889,"field  turbidity"
"1186",11849,0,2001,2001,4,-123.651778,45.750361,"field  turbidity"
"1187",11856,11,2001,2012,75,-123.842444,45.700361,"field  turbidity"
"1188",11857,2,2010,2012,71,-117.171833,44.74625,"field  turbidity"
"1189",11868,2,2005,2007,10,-124.176556,43.458028,"field  turbidity"
"1190",11871,2,2005,2007,9,-124.139667,43.476806,"field  turbidity"
"1191",11872,2,2005,2007,7,-124.119972,43.487917,"field  turbidity"
"1192",11882,2,2003,2005,5,-124.318083,43.276472,"field  turbidity"
"1193",11884,2,2005,2007,35,-124.208111,43.356306,"field  turbidity"
"1194",11904,11,2001,2012,73,-123.751111,46.091167,"field  turbidity"
"1195",11905,11,2001,2012,66,-124.487889,42.794389,"field  turbidity"
"1196",11943,1,2005,2006,7,-122.759889,45.293111,"field  turbidity"
"1197",11967,0,2005,2005,1,-121.543306,45.627167,"field  turbidity"
"1198",11968,0,2005,2005,4,-121.543222,45.626444,"field  turbidity"
"1199",11969,0,2005,2005,1,-121.543889,45.627972,"field  turbidity"
"1200",11971,0,2005,2005,3,-121.512917,45.644222,"field  turbidity"
"1201",11972,6,2005,2011,44,-121.51517,45.64377,"field  turbidity"
"1202",11973,0,2005,2005,2,-121.52925,45.627583,"field  turbidity"
"1203",11974,0,2005,2005,2,-121.527333,45.627722,"field  turbidity"
"1204",11990,1,2006,2007,3,-122.955222,44.024444,"field  turbidity"
"1205",12005,11,2001,2012,83,-118.823028,45.654444,"field  turbidity"
"1206",12012,11,2001,2012,142,-121.506722,45.710722,"field  turbidity"
"1207",12015,0,2011,2011,4,-119.341281,45.784772,"field  turbidity"
"1208",12026,1,2011,2012,3,-119.198083,45.74225,"field  turbidity"
"1209",12042,2,2006,2008,15,-121.664722,45.699167,"field  turbidity"
"1210",12044,0,2007,2007,1,-121.171111,45.601111,"field  turbidity"
"1211",12053,0,2001,2001,1,-118.4025,45.2624,"field  turbidity"
"1212",12054,0,2001,2001,1,-118.4043,45.2627,"field  turbidity"
"1213",12055,4,2001,2005,6,-118.4287,45.2697,"field  turbidity"
"1214",12057,4,2001,2005,6,-118.4017,45.2608,"field  turbidity"
"1215",12058,2,2001,2003,6,-118.5295,45.2699,"field  turbidity"
"1216",12059,2,2001,2003,5,-118.3828,45.275,"field  turbidity"
"1217",12061,2,2003,2005,18,-122.762694,44.9865,"field  turbidity"
"1218",12095,2,2005,2007,4,-124.089861,42.048972,"field  turbidity"
"1219",12099,6,2002,2008,11,-124.231306,42.488083,"field  turbidity"
"1220",12134,0,2007,2007,1,-123.944167,43.69,"field  turbidity"
"1221",12166,0,2006,2006,9,-121.452472,45.704028,"field  turbidity"
"1222",12181,1,2002,2003,5,-118.533,45.0912,"field  turbidity"
"1223",12182,1,2002,2003,3,-118.2985,45.107472,"field  turbidity"
"1224",12183,3,2002,2005,6,-118.3307,45.102556,"field  turbidity"
"1225",12187,11,2001,2012,63,-123.785583,46.069556,"field  turbidity"
"1226",12189,0,2005,2005,1,-118.833306,45.671639,"field  turbidity"
"1227",12212,0,2005,2005,7,-120.716583,44.299083,"field  turbidity"
"1228",12215,5,2002,2007,2,-123.253833,45.567306,"field  turbidity"
"1229",12243,0,2006,2006,1,-123.3575,43.071667,"field  turbidity"
"1230",12244,0,2004,2004,2,-123.287222,43.023889,"field  turbidity"
"1231",12245,4,2002,2006,5,-123.298333,43.016944,"field  turbidity"
"1232",12248,0,2002,2002,4,-123.4275,43.117778,"field  turbidity"
"1233",12251,0,2002,2002,1,-123.385556,43.080861,"field  turbidity"
"1234",12254,0,2006,2006,4,-123.330917,43.040861,"field  turbidity"
"1235",12257,2,2001,2003,3,-119.088583,43.652417,"field  turbidity"
"1236",12258,7,2001,2008,5,-117.729878,43.007536,"field  turbidity"
"1237",12260,5,2001,2006,4,-117.609444,42.805056,"field  turbidity"
"1238",12261,11,2001,2012,9,-116.995278,42.911389,"field  turbidity"
"1239",12262,7,2001,2008,5,-117.180944,42.52625,"field  turbidity"
"1240",12263,7,2001,2008,5,-117.156389,42.543944,"field  turbidity"
"1241",12264,11,2001,2012,7,-118.234111,42.337611,"field  turbidity"
"1242",12265,11,2001,2012,10,-118.866583,42.801083,"field  turbidity"
"1243",12266,11,2001,2012,11,-119.841944,42.176111,"field  turbidity"
"1244",12267,11,2001,2012,9,-119.926667,42.174444,"field  turbidity"
"1245",12269,5,2001,2006,4,-118.369333,42.187167,"field  turbidity"
"1246",12301,1,2007,2008,21,-123.774778,44.635222,"field  turbidity"
"1247",12303,6,2002,2008,60,-122.866778,42.324833,"field  turbidity"
"1248",12308,6,2002,2008,94,-122.715722,42.214417,"field  turbidity"
"1249",12368,0,2002,2002,7,-123.9155,46.019,"field  turbidity"
"1250",12376,6,2002,2008,55,-122.787167,42.253778,"field  turbidity"
"1251",12377,6,2002,2008,61,-122.870667,42.332722,"field  turbidity"
"1252",12473,6,2004,2010,10,-124.077194,43.113139,"field  turbidity"
"1253",12476,6,2004,2010,13,-124.152139,43.052833,"field  turbidity"
"1254",12488,0,2001,2001,3,-121.94731,42.133347,"field  turbidity"
"1255",12490,0,2003,2003,4,-121.7775,41.996667,"field  turbidity"
"1256",12509,0,2007,2007,1,-123.439444,44.138889,"field  turbidity"
"1257",12511,1,2008,2009,6,-123.696222,45.091861,"field  turbidity"
"1258",12521,0,2007,2007,1,-123.971083,43.963306,"field  turbidity"
"1259",12534,6,2002,2008,94,-122.738722,42.222722,"field  turbidity"
"1260",12535,6,2002,2008,95,-122.810056,42.279139,"field  turbidity"
"1261",12536,6,2002,2008,94,-122.884278,42.36525,"field  turbidity"
"1262",12537,6,2002,2008,95,-122.924472,42.394417,"field  turbidity"
"1263",12543,0,2004,2004,2,-121.119278,45.450639,"field  turbidity"
"1264",12546,1,2004,2005,3,-121.118972,45.450639,"field  turbidity"
"1265",12547,1,2004,2005,3,-121.120194,45.450861,"field  turbidity"
"1266",12552,11,2001,2012,40,-122.161389,44.174167,"field  turbidity"
"1267",12553,11,2001,2012,55,-122.411667,44.752778,"field  turbidity"
"1268",12559,11,2001,2012,60,-122.048611,44.693222,"field  turbidity"
"1269",12560,1,2001,2002,5,-121.52883,43.77214,"field  turbidity"
"1270",12561,1,2001,2002,3,-121.305833,44.079167,"field  turbidity"
"1271",12564,0,2001,2001,1,-121.840194,43.496778,"field  turbidity"
"1272",12565,1,2001,2002,4,-121.677389,43.520778,"field  turbidity"
"1273",12566,0,2001,2001,1,-121.333833,44.461306,"field  turbidity"
"1274",12567,1,2001,2002,4,-121.4761,43.7705,"field  turbidity"
"1275",12568,2,2008,2010,3,-123.278361,42.942028,"field  turbidity"
"1276",12569,0,2010,2010,1,-123.279722,42.942694,"field  turbidity"
"1277",12570,6,2002,2008,8,-123.2805,42.942861,"field  turbidity"
"1278",12573,0,2002,2002,1,-123.279889,42.942556,"field  turbidity"
"1279",12587,3,2002,2005,43,-122.955806,42.426389,"field  turbidity"
"1280",12588,6,2002,2008,60,-122.935222,42.3895,"field  turbidity"
"1281",12590,11,2001,2012,115,-124.451694,42.916278,"field  turbidity"
"1282",12604,0,2009,2009,1,-124.179806,43.57175,"field  turbidity"
"1283",12605,0,2009,2009,1,-124.180111,43.571306,"field  turbidity"
"1284",12616,0,2004,2004,2,-117.828278,44.816719,"field  turbidity"
"1285",12617,8,2004,2012,6,-117.828528,44.817083,"field  turbidity"
"1286",12621,0,2004,2004,2,-117.827664,44.818003,"field  turbidity"
"1287",12624,1,2011,2012,7,-117.883944,45.01375,"field  turbidity"
"1288",12627,1,2011,2012,3,-117.900778,45.034722,"field  turbidity"
"1289",12655,4,2001,2005,22,-122.339778,44.155444,"field  turbidity"
"1290",12656,4,2001,2005,24,-122.259139,44.157333,"field  turbidity"
"1291",12657,4,2001,2005,8,-121.995611,44.35625,"field  turbidity"
"1292",12692,0,2003,2003,6,-123.929167,46.100278,"field  turbidity"
"1293",12719,1,2007,2008,26,-122.927056,42.362583,"field  turbidity"
"1294",12720,0,2002,2002,1,-122.929722,42.374694,"field  turbidity"
"1295",12728,1,2007,2008,25,-122.919611,42.362694,"field  turbidity"
"1296",12796,4,2002,2006,15,-123.240833,43.443306,"field  turbidity"
"1297",12797,1,2004,2005,3,-123.232833,43.458083,"field  turbidity"
"1298",12799,1,2004,2005,3,-123.230222,43.449639,"field  turbidity"
"1299",12800,4,2002,2006,12,-123.3075,43.421111,"field  turbidity"
"1300",12803,4,2002,2006,17,-123.163861,43.409,"field  turbidity"
"1301",12807,3,2002,2005,12,-123.324417,43.416333,"field  turbidity"
"1302",12808,1,2004,2005,3,-123.392944,43.383417,"field  turbidity"
"1303",12832,0,2007,2007,2,-123.857111,45.501278,"field  turbidity"
"1304",12866,0,2001,2001,14,-123.874444,45.733333,"field  turbidity"
"1305",12867,0,2001,2001,2,-123.830556,45.785556,"field  turbidity"
"1306",12868,0,2003,2003,3,-123.168611,44.055556,"field  turbidity"
"1307",12869,0,2003,2003,2,-123.154444,44.054444,"field  turbidity"
"1308",12899,2,2004,2006,34,-123.294056,43.022,"field  turbidity"
"1309",12911,7,2002,2009,2,-123.355083,42.949972,"field  turbidity"
"1310",12913,0,2002,2002,1,-123.3565,42.949556,"field  turbidity"
"1311",12974,0,2009,2009,1,-123.205556,46.107222,"field  turbidity"
"1312",12975,0,2009,2009,1,-123.207222,46.107222,"field  turbidity"
"1313",12978,0,2009,2009,1,-122.943056,46.091667,"field  turbidity"
"1314",12997,4,2001,2005,6,-118.4174,45.2665,"field  turbidity"
"1315",12999,1,2004,2005,3,-117.528658,45.577581,"field  turbidity"
"1316",13002,1,2004,2005,3,-117.529097,45.578061,"field  turbidity"
"1317",13014,11,2001,2012,9,-118.763167,42.63875,"field  turbidity"
"1318",13039,0,2007,2007,2,-123.841806,45.468194,"field  turbidity"
"1319",13049,8,2002,2010,2,-123.430639,42.741167,"field  turbidity"
"1320",13050,0,2010,2010,1,-123.430611,42.738944,"field  turbidity"
"1321",13051,0,2010,2010,1,-123.430667,42.741417,"field  turbidity"
"1322",13053,0,2010,2010,1,-123.433639,42.74225,"field  turbidity"
"1323",13055,0,2006,2006,1,-116.998333,43.902222,"field  turbidity"
"1324",13056,0,2006,2006,3,-116.982778,43.875278,"field  turbidity"
"1325",13057,0,2006,2006,3,-116.988056,43.875833,"field  turbidity"
"1326",13064,0,2006,2006,1,-117.248056,44.354722,"field  turbidity"
"1327",13065,0,2006,2006,1,-117.250028,44.357167,"field  turbidity"
"1328",13066,0,2006,2006,1,-117.251917,44.357056,"field  turbidity"
"1329",13067,0,2006,2006,1,-117.255667,44.356417,"field  turbidity"
"1330",13070,11,2001,2012,100,-122.360361,45.299389,"field  turbidity"
"1331",13073,0,2006,2006,1,-122.571806,42.546806,"field  turbidity"
"1332",13074,0,2006,2006,1,-122.567306,42.547694,"field  turbidity"
"1333",13075,0,2006,2006,1,-122.568944,42.547778,"field  turbidity"
"1334",13140,0,2008,2008,5,-121.686417,45.556972,"field  turbidity"
"1335",13141,6,2005,2011,102,-121.524611,45.663722,"field  turbidity"
"1336",13148,4,2006,2010,23,-121.518972,45.699083,"field  turbidity"
"1337",13152,0,2008,2008,1,-121.635,45.600083,"field  turbidity"
"1338",13164,0,2006,2006,18,-121.563278,45.509111,"field  turbidity"
"1339",13171,0,2005,2005,1,-121.522028,45.62875,"field  turbidity"
"1340",13172,0,2005,2005,2,-121.543694,45.623917,"field  turbidity"
"1341",13173,0,2005,2005,4,-121.544222,45.631361,"field  turbidity"
"1342",13182,0,2005,2005,15,-121.51525,45.520667,"field  turbidity"
"1343",13183,1,2005,2006,33,-121.499,45.593806,"field  turbidity"
"1344",13184,1,2005,2006,32,-121.499167,45.593417,"field  turbidity"
"1345",13195,2,2003,2005,2,-123.5225,45.245861,"field  turbidity"
"1346",13196,2,2003,2005,2,-123.483222,42.523528,"field  turbidity"
"1347",13216,0,2009,2009,2,-124.007806,43.490444,"field  turbidity"
"1348",13229,0,2007,2007,2,-124.156639,42.437861,"field  turbidity"
"1349",13249,1,2010,2011,22,-121.542472,45.642361,"field  turbidity"
"1350",13263,0,2005,2005,1,-123.971944,44.216139,"field  turbidity"
"1351",13295,0,2001,2001,9,-123.8821,45.6916,"field  turbidity"
"1352",13296,0,2001,2001,6,-123.9013,45.6886,"field  turbidity"
"1353",13298,0,2001,2001,8,-123.930278,45.661111,"field  turbidity"
"1354",13319,0,2008,2008,3,-124.003333,44.893056,"field  turbidity"
"1355",13334,1,2008,2009,8,-124.013611,44.611111,"field  turbidity"
"1356",13336,1,2008,2009,4,-123.938056,44.5975,"field  turbidity"
"1357",13339,1,2008,2009,4,-123.938889,44.615278,"field  turbidity"
"1358",13343,1,2008,2009,4,-123.928056,44.6075,"field  turbidity"
"1359",13345,1,2008,2009,4,-124.008056,44.5775,"field  turbidity"
"1360",13347,0,2009,2009,1,-123.9625,44.585,"field  turbidity"
"1361",13348,1,2008,2009,3,-123.956667,44.588889,"field  turbidity"
"1362",13352,1,2008,2009,4,-124.072556,44.434667,"field  turbidity"
"1363",13363,1,2008,2009,4,-124.077222,43.977222,"field  turbidity"
"1364",13364,6,2003,2009,5,-124.06,43.976667,"field  turbidity"
"1365",13368,11,2001,2012,9,-123.771417,45.722333,"field  turbidity"
"1366",13372,0,2001,2001,7,-124.1,43.709722,"field  turbidity"
"1367",13379,2,2005,2007,10,-124.264444,43.423056,"field  turbidity"
"1368",13384,2,2005,2007,10,-124.20725,43.373889,"field  turbidity"
"1369",13386,0,2006,2006,4,-124.208889,43.364167,"field  turbidity"
"1370",13388,2,2005,2007,38,-124.192778,43.356667,"field  turbidity"
"1371",13389,1,2006,2007,27,-124.206944,43.301389,"field  turbidity"
"1372",13391,2,2003,2005,5,-124.320278,43.347028,"field  turbidity"
"1373",13393,2,2003,2005,5,-124.320444,43.33975,"field  turbidity"
"1374",13394,2,2003,2005,6,-124.320278,43.336944,"field  turbidity"
"1375",13395,2,2003,2005,5,-124.319611,43.333972,"field  turbidity"
"1376",13405,6,2004,2010,12,-124.277278,43.153972,"field  turbidity"
"1377",13411,11,2001,2012,68,-123.872306,45.575167,"field  turbidity"
"1378",13417,11,2001,2012,61,-123.842583,45.496306,"field  turbidity"
"1379",13421,11,2001,2012,56,-123.843111,45.478028,"field  turbidity"
"1380",13424,11,2001,2012,55,-123.735611,45.471806,"field  turbidity"
"1381",13428,5,2007,2012,41,-123.843889,45.465278,"field  turbidity"
"1382",13429,5,2007,2012,38,-123.809167,45.470833,"field  turbidity"
"1383",13430,5,2007,2012,44,-123.844444,45.459167,"field  turbidity"
"1384",13431,5,2007,2012,40,-123.85853,45.456389,"field  turbidity"
"1385",13433,11,2001,2012,60,-123.822778,45.429861,"field  turbidity"
"1386",13440,11,2001,2012,67,-123.824722,45.408611,"field  turbidity"
"1387",13450,1,2002,2003,55,-123.954,45.2119,"field  turbidity"
"1388",13459,1,2008,2009,6,-123.996139,45.041111,"field  turbidity"
"1389",13518,2,2005,2007,9,-124.152083,43.366583,"field  turbidity"
"1390",13519,2,2003,2005,6,-124.322194,43.312639,"field  turbidity"
"1391",13520,2,2003,2005,7,-124.318333,43.306667,"field  turbidity"
"1392",13521,2,2003,2005,5,-124.313361,43.306111,"field  turbidity"
"1393",13524,2,2005,2007,9,-124.173667,43.380611,"field  turbidity"
"1394",13525,6,2004,2010,13,-124.399444,43.146944,"field  turbidity"
"1395",13530,2,2008,2010,9,-124.408333,43.1225,"field  turbidity"
"1396",13540,0,2006,2006,6,-124.192222,43.335556,"field  turbidity"
"1397",13542,2,2005,2007,9,-124.208889,43.403889,"field  turbidity"
"1398",13568,0,2009,2009,3,-124.023333,43.433056,"field  turbidity"
"1399",13569,0,2009,2009,3,-124.030556,43.425,"field  turbidity"
"1400",13570,11,2001,2012,76,-124.058583,43.405667,"field  turbidity"
"1401",13574,11,2001,2012,62,-124.083083,43.363861,"field  turbidity"
"1402",13575,2,2005,2007,10,-124.147278,43.288694,"field  turbidity"
"1403",13577,2,2005,2007,10,-124.155222,43.3365,"field  turbidity"
"1404",13578,0,2005,2005,3,-124.1575,43.343333,"field  turbidity"
"1405",13579,2,2005,2007,13,-124.172722,43.349444,"field  turbidity"
"1406",13581,2,2005,2007,12,-124.174722,43.363333,"field  turbidity"
"1407",13583,2,2005,2007,31,-124.204083,43.325778,"field  turbidity"
"1408",13584,2,2005,2007,11,-124.225278,43.340556,"field  turbidity"
"1409",13587,0,2007,2007,5,-124.233611,43.438333,"field  turbidity"
"1410",13588,2,2005,2007,10,-124.188056,43.466111,"field  turbidity"
"1411",13589,2,2005,2007,9,-124.1925,43.462222,"field  turbidity"
"1412",13593,2,2005,2007,9,-124.169444,43.432222,"field  turbidity"
"1413",13594,2,2005,2007,10,-124.186944,43.4225,"field  turbidity"
"1414",13598,2,2005,2007,9,-124.229722,43.400556,"field  turbidity"
"1415",13601,2,2003,2005,5,-124.3085,43.339972,"field  turbidity"
"1416",13605,2,2005,2007,10,-124.233889,43.431389,"field  turbidity"
"1417",13620,2,2003,2005,5,-124.322472,43.342944,"field  turbidity"
"1418",13634,2,2003,2005,6,-124.313833,43.323167,"field  turbidity"
"1419",13640,0,2001,2001,7,-123.889528,45.709806,"field  turbidity"
"1420",13674,2,2005,2007,8,-124.220889,43.435889,"field  turbidity"
"1421",13678,1,2008,2009,4,-124.04325,44.424889,"field  turbidity"
"1422",13680,2,2008,2010,8,-124.412944,43.12075,"field  turbidity"
"1423",13685,1,2008,2009,4,-124.018889,44.580833,"field  turbidity"
"1424",13707,0,2001,2001,6,-124.108056,43.705833,"field  turbidity"
"1425",13750,0,2003,2003,2,-123.055556,43.711389,"field  turbidity"
"1426",13769,0,2003,2003,2,-122.95,43.783333,"field  turbidity"
"1427",13781,0,2002,2002,5,-122.346389,42.378056,"field  turbidity"
"1428",13782,1,2004,2005,11,-124.505139,42.896361,"field  turbidity"
"1429",13807,0,2004,2004,4,-121.774294,43.925019,"field  turbidity"
"1430",13945,0,2002,2002,4,-122.154333,43.170278,"field  turbidity"
"1431",13959,0,2003,2003,6,-123.903056,46.084167,"field  turbidity"
"1432",14008,11,2001,2012,53,-122.150861,45.162722,"field  turbidity"
"1433",14018,6,2004,2010,79,-124.118972,43.548111,"field  turbidity"
"1434",14042,0,2005,2005,2,-122.85,42.314167,"field  turbidity"
"1435",14244,0,2005,2005,1,-124.355833,43.202778,"field  turbidity"
"1436",14246,0,2005,2005,1,-124.350556,43.207778,"field  turbidity"
"1437",14247,0,2005,2005,1,-124.356111,43.2025,"field  turbidity"
"1438",14248,0,2005,2005,1,-124.350833,43.208889,"field  turbidity"
"1439",14249,0,2005,2005,1,-124.351944,43.206389,"field  turbidity"
"1440",14266,0,2002,2002,1,-124.316111,43.205278,"field  turbidity"
"1441",14268,0,2009,2009,1,-124.316389,43.210278,"field  turbidity"
"1442",14483,0,2008,2008,2,-120.3765,45.618444,"field  turbidity"
"1443",14833,0,2010,2010,1,-120.209722,45.661611,"field  turbidity"
"1444",15009,0,2009,2009,1,-124.292222,43.316667,"field  turbidity"
"1445",15011,0,2006,2006,1,-124.298056,43.321389,"field  turbidity"
"1446",15012,0,2009,2009,1,-124.298056,43.317778,"field  turbidity"
"1447",15013,0,2009,2009,1,-124.295833,43.319167,"field  turbidity"
"1448",15015,7,2002,2009,3,-124.289167,43.318333,"field  turbidity"
"1449",15016,0,2002,2002,1,-124.297778,43.319444,"field  turbidity"
"1450",15020,0,2006,2006,1,-124.291111,43.316667,"field  turbidity"
"1451",15281,0,2002,2002,1,-117.233333,43.986111,"field  turbidity"
"1452",16209,0,2009,2009,1,-119.389944,45.8495,"field  turbidity"
"1453",16212,0,2009,2009,1,-119.397056,45.846083,"field  turbidity"
"1454",16727,7,2002,2009,4,-124.318333,43.209167,"field  turbidity"
"1455",16754,7,2002,2009,2,-124.297222,43.318333,"field  turbidity"
"1456",16997,0,2005,2005,2,-120.860444,44.301972,"field  turbidity"
"1457",17036,0,2003,2003,1,-123.453444,42.139778,"field  turbidity"
"1458",17047,0,2003,2003,2,-123.533639,42.156722,"field  turbidity"
"1459",17132,0,2005,2005,4,-124.1205,43.423083,"field  turbidity"
"1460",17164,0,2002,2002,1,-122.857361,42.963389,"field  turbidity"
"1461",18741,5,2006,2011,61,-122.659722,45.41,"field  turbidity"
"1462",18742,5,2006,2011,57,-122.662722,45.465278,"field  turbidity"
"1463",18774,0,2001,2001,1,-124.105528,44.265667,"field  turbidity"
"1464",18775,0,2001,2001,1,-123.845472,44.319833,"field  turbidity"
"1465",18796,0,2001,2001,1,-123.7928,44.7456,"field  turbidity"
"1466",18797,2,2001,2003,16,-123.9003,45.1404,"field  turbidity"
"1467",18802,0,2001,2001,8,-123.769111,45.813472,"field  turbidity"
"1468",18803,0,2001,2001,2,-123.765083,43.806222,"field  turbidity"
"1469",18804,6,2001,2007,8,-124.10825,44.224194,"field  turbidity"
"1470",18821,5,2003,2008,9,-124.427583,42.965917,"field  turbidity"
"1471",18822,5,2003,2008,11,-124.414333,43.003361,"field  turbidity"
"1472",18823,5,2003,2008,12,-124.41375,43.052083,"field  turbidity"
"1473",18824,3,2003,2006,3,-124.423417,42.975472,"field  turbidity"
"1474",18826,2,2005,2007,9,-124.221806,43.433611,"field  turbidity"
"1475",18827,2,2005,2007,9,-124.214972,43.4325,"field  turbidity"
"1476",18828,2,2005,2007,9,-124.199667,43.416222,"field  turbidity"
"1477",18829,2,2005,2007,9,-124.203139,43.405417,"field  turbidity"
"1478",20389,0,2001,2001,2,-123.779472,45.827167,"field  turbidity"
"1479",20391,0,2005,2005,1,-124.067333,42.8885,"field  turbidity"
"1480",20392,1,2004,2005,5,-124.06725,42.88875,"field  turbidity"
"1481",20394,6,2005,2011,7,-124.067417,42.888111,"field  turbidity"
"1482",20440,0,2001,2001,8,-123.845556,45.695306,"field  turbidity"
"1483",20447,5,2004,2009,33,-124.096472,43.595028,"field  turbidity"
"1484",20835,0,2003,2003,2,-123.142611,44.054389,"field  turbidity"
"1485",20846,0,2003,2003,1,-123.134306,44.059944,"field  turbidity"
"1486",21506,0,2002,2002,1,-122.551833,42.997944,"field  turbidity"
"1487",21517,0,2004,2004,2,-117.198333,45.433611,"field  turbidity"
"1488",21535,1,2011,2012,6,-121.500333,42.462,"field  turbidity"
"1489",21790,0,2002,2002,1,-123.979761,44.499656,"field  turbidity"
"1490",21791,0,2007,2007,2,-124.105811,44.170708,"field  turbidity"
"1491",21792,0,2003,2003,2,-123.92875,44.580669,"field  turbidity"
"1492",21794,0,2005,2005,1,-124.305169,42.804089,"field  turbidity"
"1493",21797,2,2003,2005,2,-124.185911,42.974633,"field  turbidity"
"1494",21800,0,2011,2011,7,-123.55045,45.277942,"field  turbidity"
"1495",21804,3,2002,2005,3,-123.621869,45.228936,"field  turbidity"
"1496",21805,3,2002,2005,4,-123.830931,45.351989,"field  turbidity"
"1497",21811,0,2003,2003,1,-123.51585,45.585806,"field  turbidity"
"1498",21822,2,2003,2005,3,-123.238861,42.101917,"field  turbidity"
"1499",21835,2,2003,2005,3,-122.101831,44.782844,"field  turbidity"
"1500",21839,3,2002,2005,5,-122.889283,43.740583,"field  turbidity"
"1501",21841,0,2002,2002,1,-123.125125,45.508128,"field  turbidity"
"1502",21842,1,2007,2008,2,-123.851073,44.538726,"field  turbidity"
"1503",21850,1,2003,2004,6,-123.729703,42.29775,"field  turbidity"
"1504",21877,0,2008,2008,3,-121.7812,45.464478,"field  turbidity"
"1505",22369,9,2002,2011,42,-123.706519,45.277064,"field  turbidity"
"1506",22375,0,2011,2011,6,-123.603114,45.239361,"field  turbidity"
"1507",22383,0,2011,2011,7,-123.580667,45.265833,"field  turbidity"
"1508",22386,0,2008,2008,1,-123.168453,45.436233,"field  turbidity"
"1509",22394,9,2002,2011,52,-123.818167,45.2765,"field  turbidity"
"1510",22651,5,2001,2006,34,-122.7605,44.254167,"field  turbidity"
"1511",22654,5,2001,2006,34,-122.854083,44.172861,"field  turbidity"
"1512",22954,0,2001,2001,2,-123.231222,46.128944,"field  turbidity"
"1513",22965,0,2005,2005,1,-121.495472,45.651611,"field  turbidity"
"1514",22966,0,2005,2005,1,-121.495667,45.651639,"field  turbidity"
"1515",22970,0,2005,2005,2,-121.543528,45.635028,"field  turbidity"
"1516",22971,0,2005,2005,1,-121.534306,45.628639,"field  turbidity"
"1517",22972,0,2005,2005,2,-121.530056,45.627278,"field  turbidity"
"1518",22973,0,2005,2005,2,-121.529611,45.627278,"field  turbidity"
"1519",22974,0,2005,2005,2,-121.528,45.627278,"field  turbidity"
"1520",22978,0,2005,2005,1,-121.518778,45.638889,"field  turbidity"
"1521",22985,0,2005,2005,1,-118.84027,45.668152,"field  turbidity"
"1522",22986,0,2005,2005,1,-118.84195,45.66786,"field  turbidity"
"1523",23023,0,2004,2004,1,-117.913361,45.577806,"field  turbidity"
"1524",23026,1,2004,2005,3,-117.913528,45.577083,"field  turbidity"
"1525",23038,0,2005,2005,1,-118.83934,45.66825,"field  turbidity"
"1526",23070,6,2002,2008,60,-122.851722,42.318083,"field  turbidity"
"1527",23243,0,2003,2003,16,-123.9377,45.1612,"field  turbidity"
"1528",23365,1,2003,2004,6,-123.658472,42.160433,"field  turbidity"
"1529",23390,1,2003,2004,5,-123.683292,42.243061,"field  turbidity"
"1530",23394,0,2003,2003,4,-123.774783,42.302303,"field  turbidity"
"1531",23402,0,2003,2003,1,-123.999406,42.454753,"field  turbidity"
"1532",23408,0,2002,2002,1,-124.037414,42.514094,"field  turbidity"
"1533",23487,4,2005,2009,34,-118.165106,45.829289,"field  turbidity"
"1534",23492,5,2005,2010,37,-118.333181,45.900972,"field  turbidity"
"1535",23497,0,2011,2011,3,-118.378722,46,"field  turbidity"
"1536",23509,11,2001,2012,9,-123.589979,45.84384,"field  turbidity"
"1537",23523,0,2001,2001,2,-123.375643,46.132539,"field  turbidity"
"1538",23538,0,2001,2001,2,-123.081763,46.041327,"field  turbidity"
"1539",23539,0,2001,2001,3,-123.038425,45.988468,"field  turbidity"
"1540",23738,1,2001,2002,7,-122.648483,42.439617,"field  turbidity"
"1541",23744,7,2002,2009,86,-124.033975,44.294306,"field  turbidity"
"1542",23745,7,2002,2009,79,-123.973897,44.297889,"field  turbidity"
"1543",23746,7,2002,2009,79,-123.97686,44.296922,"field  turbidity"
"1544",23747,7,2002,2009,81,-123.976861,44.316914,"field  turbidity"
"1545",23748,7,2002,2009,79,-123.974386,44.316914,"field  turbidity"
"1546",23749,7,2002,2009,81,-123.939722,44.288694,"field  turbidity"
"1547",23750,7,2002,2009,58,-123.96171,44.277481,"field  turbidity"
"1548",23751,7,2002,2009,80,-123.960472,44.277514,"field  turbidity"
"1549",23752,6,2003,2009,69,-124.027139,44.296789,"field  turbidity"
"1550",23753,5,2004,2009,20,-124.407222,42.371944,"field  turbidity"
"1551",23758,5,2001,2006,11,-123.460747,42.39476,"field  turbidity"
"1552",23759,3,2001,2004,8,-123.538817,42.363161,"field  turbidity"
"1553",23760,3,2001,2004,9,-123.579786,42.363942,"field  turbidity"
"1554",23761,5,2003,2008,16,-124.494653,42.764017,"field  turbidity"
"1555",23764,1,2001,2002,26,-122.687853,42.459283,"field  turbidity"
"1556",23765,0,2002,2002,2,-122.811075,42.537853,"field  turbidity"
"1557",23797,2,2001,2003,13,-122.826317,45.970117,"field  turbidity"
"1558",23800,2,2001,2003,14,-123.4242,46.220683,"field  turbidity"
"1559",23810,2,2006,2008,17,-122.611817,45.602366,"field  turbidity"
"1560",23812,0,2008,2008,2,-122.60665,45.60793,"field  turbidity"
"1561",23821,0,2003,2003,1,-123.68697,44.197048,"field  turbidity"
"1562",23823,0,2003,2003,1,-123.9838,44.085856,"field  turbidity"
"1563",23836,0,2005,2005,2,-123.39559,42.781741,"field  turbidity"
"1564",23837,2,2003,2005,3,-123.60948,43.45645,"field  turbidity"
"1565",23839,0,2003,2003,1,-123.20991,42.602606,"field  turbidity"
"1566",23847,4,2001,2005,3,-122.3852,44.427415,"field  turbidity"
"1567",23853,0,2003,2003,1,-123.350797,45.173487,"field  turbidity"
"1568",23854,0,2003,2003,1,-123.55147,45.000534,"field  turbidity"
"1569",23857,0,2003,2003,1,-122.677977,43.620848,"field  turbidity"
"1570",23859,2,2001,2003,26,-123.393163,44.265533,"field  turbidity"
"1571",23863,0,2007,2007,2,-123.311606,44.415841,"field  turbidity"
"1572",23864,0,2006,2006,1,-122.795884,44.966953,"field  turbidity"
"1573",23870,3,2001,2004,13,-123.065739,42.230231,"field  turbidity"
"1574",23873,0,2001,2001,4,-123.366286,45.98023,"field  turbidity"
"1575",23892,1,2006,2007,15,-122.99812,43.32422,"field  turbidity"
"1576",23897,1,2006,2007,15,-122.54524,43.29207,"field  turbidity"
"1577",23930,0,2006,2006,1,-124.498122,42.91153,"field  turbidity"
"1578",23931,0,2006,2006,1,-124.49281,42.91442,"field  turbidity"
"1579",23934,0,2001,2001,4,-123.003313,45.899925,"field  turbidity"
"1580",23958,2,2008,2010,8,-124.04154,43.25863,"field  turbidity"
"1581",23959,6,2004,2010,11,-124.00586,43.27088,"field  turbidity"
"1582",23961,6,2004,2010,11,-124.02177,43.29058,"field  turbidity"
"1583",23980,6,2004,2010,12,-124.09378,43.1865,"field  turbidity"
"1584",24037,0,2003,2003,2,-123.918611,46.128611,"field  turbidity"
"1585",24090,5,2003,2008,8,-124.31929,42.94343,"field  turbidity"
"1586",24091,4,2004,2008,9,-124.3339,42.94921,"field  turbidity"
"1587",24295,0,2003,2003,1,-123.90767,46.09176,"field  turbidity"
"1588",24297,0,2001,2001,6,-123.863198,45.731672,"field  turbidity"
"1589",24299,0,2001,2001,4,-123.201595,45.843657,"field  turbidity"
"1590",24300,0,2001,2001,4,-123.154787,45.899615,"field  turbidity"
"1591",24326,0,2002,2002,4,-123.9115,46.0107,"field  turbidity"
"1592",24349,0,2003,2003,1,-123.91404,46.0957,"field  turbidity"
"1593",24354,1,2003,2004,6,-123.779319,42.303753,"field  turbidity"
"1594",24388,0,2001,2001,7,-123.8804,45.7012,"field  turbidity"
"1595",24401,1,2004,2005,2,-123.172242,43.407381,"field  turbidity"
"1596",24409,1,2001,2002,10,-122.783508,42.440414,"field  turbidity"
"1597",24411,6,2002,2008,13,-122.849844,42.681817,"field  turbidity"
"1598",24450,1,2001,2002,3,-122.683228,42.761358,"field  turbidity"
"1599",24451,1,2001,2002,35,-122.690306,42.655872,"field  turbidity"
"1600",24457,1,2001,2002,5,-122.753197,42.663548,"field  turbidity"
"1601",24459,0,2008,2008,223,-122.8409,42.695728,"field  turbidity"
"1602",24477,5,2003,2008,7,-122.808536,42.646831,"field  turbidity"
"1603",24570,1,2002,2003,33,-123.966667,45.088611,"field  turbidity"
"1604",10085,1,2002,2003,2,-123.049056,43.808556,"nitr"
"1605",10086,2,2001,2003,2,-123.253139,44.921472,"nitr"
"1606",10087,4,2002,2006,4,-122.709167,42.211111,"nitr"
"1607",10151,2,2001,2003,21,-123.268611,44.005278,"nitr"
"1608",10332,13,2001,2014,77,-122.7475,45.577944,"nitr"
"1609",10339,13,2001,2014,90,-122.690722,45.300333,"nitr"
"1610",10342,10,2001,2011,21,-122.942361,45.267639,"nitr"
"1611",10344,12,2001,2013,59,-123.044306,45.090583,"nitr"
"1612",10350,13,2001,2014,113,-123.105778,44.639722,"nitr"
"1613",10352,13,2001,2014,132,-123.255417,44.565528,"nitr"
"1614",10355,13,2001,2014,117,-123.173667,44.267167,"nitr"
"1615",10359,13,2001,2014,65,-123.02675,44.045611,"nitr"
"1616",10363,13,2001,2014,94,-123.071583,45.223639,"nitr"
"1617",10366,13,2001,2014,72,-122.923556,44.636194,"nitr"
"1618",10373,13,2001,2014,77,-123.263639,44.556639,"nitr"
"1619",10376,13,2001,2014,66,-123.046194,44.112722,"nitr"
"1620",10386,13,2001,2014,57,-122.905278,43.998194,"nitr"
"1621",10391,13,2001,2014,72,-123.9135,44.7643,"nitr"
"1622",10392,5,2001,2006,23,-123.852139,44.030139,"nitr"
"1623",10393,13,2001,2014,70,-124.136694,43.078528,"nitr"
"1624",10398,0,2003,2003,1,-116.999361,43.866639,"nitr"
"1625",10401,0,2006,2006,2,-119.146514,44.415989,"nitr"
"1626",10404,13,2001,2014,83,-119.035389,45.677444,"nitr"
"1627",10405,0,2005,2005,2,-118.875611,45.65775,"nitr"
"1628",10406,13,2001,2014,61,-118.7585,45.674806,"nitr"
"1629",10407,13,2001,2014,71,-116.972222,44.05675,"nitr"
"1630",10408,0,2006,2006,4,-117.141361,44.000222,"nitr"
"1631",10410,13,2001,2014,65,-117.719639,45.621306,"nitr"
"1632",10411,13,2001,2014,82,-120.910167,45.630222,"nitr"
"1633",10413,3,2005,2008,5,-124.327472,42.481639,"nitr"
"1634",10414,13,2001,2014,99,-124.292167,42.503667,"nitr"
"1635",10418,13,2001,2014,76,-123.487278,42.496833,"nitr"
"1636",10421,13,2001,2014,63,-123.089389,42.432694,"nitr"
"1637",10423,13,2001,2014,72,-122.841583,42.525333,"nitr"
"1638",10425,6,2002,2008,10,-124.063489,42.548747,"nitr"
"1639",10428,11,2001,2012,56,-123.455833,42.3975,"nitr"
"1640",10433,0,2005,2005,1,-122.818333,42.280278,"nitr"
"1641",10437,13,2001,2014,51,-123.565833,43.631861,"nitr"
"1642",10441,13,2001,2014,54,-123.563444,43.635139,"nitr"
"1643",10442,13,2001,2014,70,-123.411056,43.241778,"nitr"
"1644",10443,13,2001,2014,67,-123.397944,43.133889,"nitr"
"1645",10451,13,2001,2014,31,-123.409222,43.271861,"nitr"
"1646",10456,13,2001,2014,73,-122.756278,45.386139,"nitr"
"1647",10458,13,2001,2014,71,-122.893667,45.409389,"nitr"
"1648",10459,13,2001,2014,71,-122.919778,45.444415,"nitr"
"1649",10461,13,2001,2014,71,-122.950556,45.490056,"nitr"
"1650",10466,0,2008,2008,1,-123.124056,45.477639,"nitr"
"1651",10469,13,2001,2014,83,-122.752778,45.415472,"nitr"
"1652",10480,13,2001,2014,67,-122.89875,45.520861,"nitr"
"1653",10506,13,2001,2014,69,-121.227806,44.761167,"nitr"
"1654",10508,13,2001,2014,68,-121.293778,44.359917,"nitr"
"1655",10511,13,2001,2014,47,-121.320444,44.060083,"nitr"
"1656",10517,13,2001,2014,76,-121.080694,44.348694,"nitr"
"1657",10521,13,2001,2014,70,-123.9251,45.952,"nitr"
"1658",10523,13,2001,2014,94,-123.8902,45.2071,"nitr"
"1659",10533,13,2001,2014,94,-124.481417,42.81675,"nitr"
"1660",10535,0,2009,2009,3,-124.352306,42.277056,"nitr"
"1661",10537,13,2001,2014,103,-124.186139,42.007139,"nitr"
"1662",10555,13,2001,2014,123,-123.041528,44.946111,"nitr"
"1663",10573,0,2002,2002,2,-121.838333,42.158889,"nitr"
"1664",10578,2,2005,2007,3,-123.764444,46.209722,"nitr"
"1665",10579,6,2005,2011,5,-122.642583,45.440333,"nitr"
"1666",10585,0,2008,2008,3,-123.751139,44.376111,"nitr"
"1667",10588,0,2008,2008,2,-123.875583,44.534556,"nitr"
"1668",10596,13,2001,2014,76,-124.192528,43.173778,"nitr"
"1669",10599,5,2002,2007,11,-124.061667,42.58725,"nitr"
"1670",10602,13,2001,2014,59,-122.855028,42.455444,"nitr"
"1671",10611,13,2001,2014,115,-122.669889,45.513306,"nitr"
"1672",10616,13,2001,2014,66,-122.738861,45.645639,"nitr"
"1673",10637,13,2001,2014,69,-122.709222,45.267667,"nitr"
"1674",10638,0,2008,2008,1,-122.537028,45.162694,"nitr"
"1675",10640,13,2001,2014,70,-122.792528,45.150361,"nitr"
"1676",10646,1,2005,2006,13,-122.824194,45.006583,"nitr"
"1677",10662,13,2001,2014,103,-122.831222,44.055278,"nitr"
"1678",10663,13,2001,2014,35,-122.959333,44.092306,"nitr"
"1679",10674,13,2001,2014,70,-122.375444,45.5385,"nitr"
"1680",10684,11,2001,2012,7,-121.410667,43.930806,"nitr"
"1681",10686,13,2001,2014,54,-121.451194,43.863361,"nitr"
"1682",10687,1,2001,2002,4,-121.4981,43.8174,"nitr"
"1683",10688,13,2001,2014,49,-121.607028,43.743417,"nitr"
"1684",10689,11,2001,2012,7,-121.688722,43.684417,"nitr"
"1685",10690,13,2001,2014,76,-121.619528,44.5565,"nitr"
"1686",10694,1,2001,2002,4,-121.463333,43.873028,"nitr"
"1687",10696,11,2002,2013,18,-121.4513,43.8204,"nitr"
"1688",10697,0,2002,2002,2,-121.500167,43.692306,"nitr"
"1689",10698,0,2002,2002,2,-121.572028,43.661806,"nitr"
"1690",10699,0,2002,2002,1,-121.6516,43.5248,"nitr"
"1691",10703,0,2002,2002,1,-121.696889,43.463472,"nitr"
"1692",10705,1,2001,2002,6,-121.5315,43.7943,"nitr"
"1693",10719,13,2001,2014,59,-117.909278,45.566889,"nitr"
"1694",10720,13,2001,2014,22,-118.235556,45.342111,"nitr"
"1695",10724,13,2001,2014,43,-117.4675,44.818333,"nitr"
"1696",10727,0,2006,2006,3,-117.363972,43.939472,"nitr"
"1697",10728,13,2001,2014,73,-117.229167,43.988056,"nitr"
"1698",10729,13,2001,2014,70,-117.054333,43.783861,"nitr"
"1699",10730,6,2008,2014,13,-117.622806,42.840694,"nitr"
"1700",10741,13,2001,2014,3,-119.901056,42.407139,"nitr"
"1701",10743,0,2002,2002,2,-120.545028,42.696083,"nitr"
"1702",10758,0,2003,2003,5,-121.560417,42.010278,"nitr"
"1703",10759,13,2001,2014,66,-121.622667,42.040417,"nitr"
"1704",10762,0,2003,2003,3,-121.757694,42.154,"nitr"
"1705",10763,13,2001,2014,71,-121.840722,42.079917,"nitr"
"1706",10764,13,2001,2014,59,-122.059917,42.086917,"nitr"
"1707",10765,13,2001,2014,67,-121.927778,42.128056,"nitr"
"1708",10767,0,2002,2002,7,-121.797722,42.174944,"nitr"
"1709",10768,13,2001,2014,79,-121.788361,42.218778,"nitr"
"1710",10770,12,2002,2014,52,-121.916194,42.514611,"nitr"
"1711",10783,2,2012,2014,15,-122.936889,44.690667,"nitr"
"1712",10784,2,2012,2014,15,-122.917806,44.673389,"nitr"
"1713",10792,13,2001,2014,70,-122.971111,44.708722,"nitr"
"1714",10801,13,2001,2014,80,-122.709083,45.563806,"nitr"
"1715",10811,0,2003,2003,3,-123.915833,46.168583,"nitr"
"1716",10812,13,2001,2014,78,-123.924361,46.148972,"nitr"
"1717",10817,13,2001,2014,76,-123.839972,46.075028,"nitr"
"1718",10853,0,2001,2001,2,-122.568333,45.467778,"nitr"
"1719",10887,0,2005,2005,1,-122.785278,45.205667,"nitr"
"1720",10896,1,2005,2006,6,-122.7804,45.1477,"nitr"
"1721",10899,1,2005,2006,20,-122.8225,45.1004,"nitr"
"1722",10917,13,2001,2014,87,-122.748972,45.233806,"nitr"
"1723",10929,13,2001,2014,112,-123.17417,45.25194,"nitr"
"1724",10948,12,2001,2013,74,-123.206917,45.168667,"nitr"
"1725",10949,0,2009,2009,1,-123.263222,45.107917,"nitr"
"1726",10957,0,2008,2008,4,-123.211806,45.116167,"nitr"
"1727",10991,0,2002,2002,1,-122.967528,43.789139,"nitr"
"1728",10993,0,2002,2002,1,-122.836917,43.695861,"nitr"
"1729",10996,13,2001,2014,94,-123.459528,43.366361,"nitr"
"1730",10997,13,2001,2014,68,-123.33575,42.943861,"nitr"
"1731",11003,0,2005,2005,1,-123.86088,45.229944,"nitr"
"1732",11016,0,2012,2012,2,-119.540028,44.475222,"nitr"
"1733",11017,12,2001,2013,55,-119.637694,44.756,"nitr"
"1734",11020,13,2001,2014,61,-119.531222,44.465639,"nitr"
"1735",11025,0,2012,2012,3,-122.277278,45.493361,"nitr"
"1736",11043,13,2001,2014,67,-117.268861,43.967306,"nitr"
"1737",11044,0,2006,2006,3,-117.603722,43.854389,"nitr"
"1738",11047,11,2003,2014,9,-118.331778,43.783778,"nitr"
"1739",11050,2,2011,2013,6,-117.518556,42.904917,"nitr"
"1740",11051,13,2001,2014,64,-122.937722,42.404722,"nitr"
"1741",11137,2,2001,2003,21,-123.285528,44.248333,"nitr"
"1742",11138,2,2001,2003,21,-123.291417,44.216056,"nitr"
"1743",11140,13,2001,2014,93,-123.294444,44.342861,"nitr"
"1744",11178,0,2002,2002,4,-121.777333,42.216833,"nitr"
"1745",11180,13,2001,2014,73,-123.127472,44.620222,"nitr"
"1746",11181,0,2013,2013,4,-123.148194,44.565583,"nitr"
"1747",11182,3,2011,2014,17,-123.107472,44.504611,"nitr"
"1748",11188,2,2012,2014,15,-123.112306,44.603556,"nitr"
"1749",11201,13,2001,2014,88,-122.753056,45.6105,"nitr"
"1750",11233,13,2001,2014,65,-122.583139,45.378722,"nitr"
"1751",11241,13,2001,2014,72,-123.944972,45.023417,"nitr"
"1752",11262,0,2007,2007,1,-123.941972,44.405306,"nitr"
"1753",11263,13,2001,2014,73,-123.831,44.382694,"nitr"
"1754",11275,13,2001,2014,79,-122.985111,44.010028,"nitr"
"1755",11278,0,2002,2002,1,-123.049139,43.718028,"nitr"
"1756",11304,3,2001,2004,4,-123.337306,43.658306,"nitr"
"1757",11305,3,2001,2004,3,-123.316139,43.660361,"nitr"
"1758",11306,4,2001,2005,3,-123.279333,43.604222,"nitr"
"1759",11310,2,2002,2004,6,-123.341361,43.2135,"nitr"
"1760",11316,0,2004,2004,1,-123.294944,43.022944,"nitr"
"1761",11321,13,2001,2014,75,-122.64225,45.447167,"nitr"
"1762",11323,0,2001,2001,2,-122.616111,45.461667,"nitr"
"1763",11326,0,2001,2001,3,-122.467778,45.486111,"nitr"
"1764",11386,13,2001,2014,24,-120.468639,45.476861,"nitr"
"1765",11387,0,2012,2012,3,-121.095528,45.239944,"nitr"
"1766",11434,13,2001,2014,85,-123.197583,46.102028,"nitr"
"1767",11457,13,2001,2014,36,-117.729944,45.619556,"nitr"
"1768",11476,13,2001,2014,84,-123.834778,44.657667,"nitr"
"1769",11477,12,2002,2014,41,-120.541139,44.172556,"nitr"
"1770",11478,13,2001,2014,63,-120.002694,44.792417,"nitr"
"1771",11479,13,2001,2014,62,-119.470494,44.466331,"nitr"
"1772",11480,13,2001,2014,66,-117.507583,43.910333,"nitr"
"1773",11482,13,2001,2014,93,-123.68675,42.238389,"nitr"
"1774",11483,13,2001,2014,62,-124.185889,42.123722,"nitr"
"1775",11484,13,2001,2014,78,-123.21575,42.970944,"nitr"
"1776",11485,12,2001,2013,55,-124.113167,43.032944,"nitr"
"1777",11486,13,2001,2014,62,-124.149333,43.008528,"nitr"
"1778",11489,13,2001,2014,67,-119.331944,45.835694,"nitr"
"1779",11490,13,2001,2014,95,-117.826667,44.781944,"nitr"
"1780",11491,8,2006,2014,62,-123.861972,43.788778,"nitr"
"1781",11493,13,2001,2014,107,-124.395556,42.272222,"nitr"
"1782",11494,13,2001,2014,66,-117.251947,44.356872,"nitr"
"1783",11505,2,2006,2008,24,-123.199583,45.152722,"nitr"
"1784",11514,1,2005,2006,12,-122.783333,45.095333,"nitr"
"1785",11515,1,2005,2006,13,-122.787222,45.088222,"nitr"
"1786",11521,13,2001,2014,55,-117.962611,45.349722,"nitr"
"1787",11522,13,2001,2014,70,-123.365556,43.217778,"nitr"
"1788",11527,0,2005,2005,1,-123.178333,45.214444,"nitr"
"1789",11539,0,2003,2003,1,-123.116111,44.094722,"nitr"
"1790",11543,0,2005,2005,1,-118.838861,45.668556,"nitr"
"1791",11544,4,2006,2010,4,-122.700028,45.614333,"nitr"
"1792",11545,4,2002,2006,5,-123.395722,43.211056,"nitr"
"1793",11550,0,2003,2003,1,-123.837333,45.485667,"nitr"
"1794",11551,10,2001,2011,9,-122.759444,45.404167,"nitr"
"1795",11555,9,2002,2011,7,-122.656667,45.417778,"nitr"
"1796",11556,1,2002,2003,3,-123.201111,42.41875,"nitr"
"1797",11558,0,2002,2002,2,-121.769222,42.197278,"nitr"
"1798",11571,0,2006,2006,1,-124.105972,43.071667,"nitr"
"1799",11586,0,2008,2008,2,-117.231772,45.397994,"nitr"
"1800",11587,0,2008,2008,1,-117.232644,45.398289,"nitr"
"1801",11598,0,2003,2003,1,-121.790667,42.178444,"nitr"
"1802",11600,0,2002,2002,5,-121.781694,42.192389,"nitr"
"1803",11626,8,2001,2009,16,-122.402278,45.473056,"nitr"
"1804",11655,0,2002,2002,1,-122.529528,43.011083,"nitr"
"1805",11704,0,2007,2007,5,-124.222139,43.177139,"nitr"
"1806",11724,0,2007,2007,2,-124.146611,43.06975,"nitr"
"1807",11725,2,2007,2009,5,-124.193667,43.173583,"nitr"
"1808",11778,1,2005,2006,7,-120.793333,44.109722,"nitr"
"1809",11788,0,2009,2009,1,-123.18475,45.855639,"nitr"
"1810",11824,2,2001,2003,2,-122.802694,45.008694,"nitr"
"1811",11850,0,2007,2007,1,-124.105722,44.186639,"nitr"
"1812",11856,13,2001,2014,86,-123.842444,45.700361,"nitr"
"1813",11857,3,2010,2013,12,-117.171833,44.74625,"nitr"
"1814",11884,1,2006,2007,26,-124.208111,43.356306,"nitr"
"1815",11904,13,2001,2014,82,-123.751111,46.091167,"nitr"
"1816",11905,13,2001,2014,89,-124.487889,42.794389,"nitr"
"1817",11940,9,2002,2011,7,-122.7695,45.294167,"nitr"
"1818",11943,0,2006,2006,1,-122.759889,45.293111,"nitr"
"1819",11968,0,2005,2005,4,-121.543222,45.626444,"nitr"
"1820",11969,0,2005,2005,1,-121.543889,45.627972,"nitr"
"1821",11971,0,2005,2005,4,-121.512917,45.644222,"nitr"
"1822",11972,7,2005,2012,6,-121.51517,45.64377,"nitr"
"1823",11973,0,2005,2005,2,-121.52925,45.627583,"nitr"
"1824",11974,0,2005,2005,2,-121.527333,45.627722,"nitr"
"1825",12005,13,2001,2014,84,-118.823028,45.654444,"nitr"
"1826",12012,13,2001,2014,72,-121.506722,45.710722,"nitr"
"1827",12026,1,2011,2012,3,-119.198083,45.74225,"nitr"
"1828",12055,0,2003,2003,1,-118.4287,45.2697,"nitr"
"1829",12057,4,2001,2005,5,-118.4017,45.2608,"nitr"
"1830",12058,0,2003,2003,1,-118.5295,45.2699,"nitr"
"1831",12059,2,2001,2003,5,-118.3828,45.275,"nitr"
"1832",12091,0,2007,2007,1,-123.982389,42.044306,"nitr"
"1833",12092,0,2007,2007,1,-124.049472,42.457889,"nitr"
"1834",12095,0,2007,2007,2,-124.089861,42.048972,"nitr"
"1835",12099,0,2002,2002,4,-124.231306,42.488083,"nitr"
"1836",12134,0,2007,2007,1,-123.944167,43.69,"nitr"
"1837",12181,1,2002,2003,4,-118.533,45.0912,"nitr"
"1838",12187,13,2001,2014,72,-123.785583,46.069556,"nitr"
"1839",12189,0,2005,2005,1,-118.833306,45.671639,"nitr"
"1840",12212,0,2005,2005,3,-120.716583,44.299083,"nitr"
"1841",12215,5,2002,2007,2,-123.253833,45.567306,"nitr"
"1842",12245,2,2002,2004,3,-123.298333,43.016944,"nitr"
"1843",12248,0,2004,2004,1,-123.4275,43.117778,"nitr"
"1844",12251,0,2004,2004,1,-123.385556,43.080861,"nitr"
"1845",12257,0,2001,2001,1,-119.088583,43.652417,"nitr"
"1846",12258,7,2001,2008,5,-117.729878,43.007536,"nitr"
"1847",12260,5,2001,2006,4,-117.609444,42.805056,"nitr"
"1848",12261,12,2002,2014,14,-116.995278,42.911389,"nitr"
"1849",12262,7,2001,2008,5,-117.180944,42.52625,"nitr"
"1850",12264,12,2002,2014,6,-118.234111,42.337611,"nitr"
"1851",12265,13,2001,2014,17,-118.866583,42.801083,"nitr"
"1852",12266,12,2001,2013,10,-119.841944,42.176111,"nitr"
"1853",12267,11,2002,2013,6,-119.926667,42.174444,"nitr"
"1854",12269,0,2006,2006,1,-118.369333,42.187167,"nitr"
"1855",12278,0,2007,2007,1,-123.588278,45.494944,"nitr"
"1856",12301,0,2008,2008,9,-123.774778,44.635222,"nitr"
"1857",12346,0,2003,2003,1,-121.908139,44.431722,"nitr"
"1858",12351,0,2003,2003,1,-123.939889,45.609722,"nitr"
"1859",12488,0,2001,2001,3,-121.94731,42.133347,"nitr"
"1860",12490,0,2003,2003,4,-121.7775,41.996667,"nitr"
"1861",12509,0,2007,2007,1,-123.439444,44.138889,"nitr"
"1862",12521,0,2007,2007,1,-123.971083,43.963306,"nitr"
"1863",12550,0,2012,2012,3,-121.115444,45.451194,"nitr"
"1864",12552,13,2001,2014,46,-122.161389,44.174167,"nitr"
"1865",12553,13,2001,2014,63,-122.411667,44.752778,"nitr"
"1866",12559,13,2001,2014,58,-122.048611,44.693222,"nitr"
"1867",12560,1,2001,2002,5,-121.52883,43.77214,"nitr"
"1868",12561,11,2001,2012,6,-121.305833,44.079167,"nitr"
"1869",12565,0,2002,2002,1,-121.677389,43.520778,"nitr"
"1870",12566,1,2001,2002,2,-121.333833,44.461306,"nitr"
"1871",12567,0,2002,2002,2,-121.4761,43.7705,"nitr"
"1872",12570,0,2008,2008,1,-123.2805,42.942861,"nitr"
"1873",12573,0,2002,2002,1,-123.279889,42.942556,"nitr"
"1874",12578,0,2002,2002,1,-123.891028,45.206028,"nitr"
"1875",12590,13,2001,2014,100,-124.451694,42.916278,"nitr"
"1876",12604,0,2009,2009,1,-124.179806,43.57175,"nitr"
"1877",12605,0,2009,2009,1,-124.180111,43.571306,"nitr"
"1878",12617,9,2002,2011,7,-117.828528,44.817083,"nitr"
"1879",12624,2,2011,2013,4,-117.883944,45.01375,"nitr"
"1880",12627,2,2011,2013,5,-117.900778,45.034722,"nitr"
"1881",12655,4,2001,2005,18,-122.339778,44.155444,"nitr"
"1882",12656,4,2001,2005,19,-122.259139,44.157333,"nitr"
"1883",12657,4,2001,2005,12,-121.995611,44.35625,"nitr"
"1884",12692,0,2003,2003,8,-123.929167,46.100278,"nitr"
"1885",12796,4,2002,2006,4,-123.240833,43.443306,"nitr"
"1886",12800,4,2002,2006,3,-123.3075,43.421111,"nitr"
"1887",12803,4,2002,2006,6,-123.163861,43.409,"nitr"
"1888",12807,0,2002,2002,3,-123.324417,43.416333,"nitr"
"1889",12832,0,2007,2007,2,-123.857111,45.501278,"nitr"
"1890",12841,11,2002,2013,7,-123.855361,45.456944,"nitr"
"1891",12900,0,2004,2004,1,-123.395278,43.2115,"nitr"
"1892",12911,7,2002,2009,2,-123.355083,42.949972,"nitr"
"1893",12913,0,2002,2002,1,-123.3565,42.949556,"nitr"
"1894",12974,0,2009,2009,1,-123.205556,46.107222,"nitr"
"1895",12975,0,2009,2009,1,-123.207222,46.107222,"nitr"
"1896",12978,0,2009,2009,1,-122.943056,46.091667,"nitr"
"1897",12982,0,2002,2002,1,-123.9653,45.2103,"nitr"
"1898",12987,8,2003,2011,3,-123.8,46.143333,"nitr"
"1899",12997,1,2001,2002,2,-118.4174,45.2665,"nitr"
"1900",13014,12,2001,2013,12,-118.763167,42.63875,"nitr"
"1901",13049,4,2002,2006,2,-123.430639,42.741167,"nitr"
"1902",13050,0,2002,2002,1,-123.430611,42.738944,"nitr"
"1903",13055,0,2006,2006,1,-116.998333,43.902222,"nitr"
"1904",13056,0,2006,2006,3,-116.982778,43.875278,"nitr"
"1905",13057,0,2006,2006,3,-116.988056,43.875833,"nitr"
"1906",13064,0,2006,2006,1,-117.248056,44.354722,"nitr"
"1907",13065,0,2006,2006,1,-117.250028,44.357167,"nitr"
"1908",13066,0,2006,2006,1,-117.251917,44.357056,"nitr"
"1909",13067,0,2006,2006,1,-117.255667,44.356417,"nitr"
"1910",13070,13,2001,2014,107,-122.360361,45.299389,"nitr"
"1911",13073,0,2006,2006,1,-122.571806,42.546806,"nitr"
"1912",13075,0,2006,2006,1,-122.568944,42.547778,"nitr"
"1913",13138,0,2012,2012,3,-121.612639,45.569694,"nitr"
"1914",13139,0,2012,2012,2,-121.6315,45.56175,"nitr"
"1915",13140,0,2012,2012,3,-121.686417,45.556972,"nitr"
"1916",13141,7,2005,2012,5,-121.524611,45.663722,"nitr"
"1917",13148,0,2012,2012,3,-121.518972,45.699083,"nitr"
"1918",13171,0,2005,2005,2,-121.522028,45.62875,"nitr"
"1919",13172,0,2005,2005,2,-121.543694,45.623917,"nitr"
"1920",13173,0,2005,2005,4,-121.544222,45.631361,"nitr"
"1921",13195,3,2002,2005,3,-123.5225,45.245861,"nitr"
"1922",13216,0,2009,2009,3,-124.007806,43.490444,"nitr"
"1923",13223,0,2007,2007,2,-123.742306,45.595028,"nitr"
"1924",13229,0,2007,2007,2,-124.156639,42.437861,"nitr"
"1925",13253,0,2012,2012,3,-121.5441,45.6432,"nitr"
"1926",13263,0,2005,2005,1,-123.971944,44.216139,"nitr"
"1927",13368,1,2012,2013,15,-123.771417,45.722333,"nitr"
"1928",13386,0,2006,2006,4,-124.208889,43.364167,"nitr"
"1929",13388,1,2006,2007,27,-124.192778,43.356667,"nitr"
"1930",13389,1,2006,2007,28,-124.206944,43.301389,"nitr"
"1931",13411,13,2001,2014,80,-123.872306,45.575167,"nitr"
"1932",13417,13,2001,2014,76,-123.842583,45.496306,"nitr"
"1933",13421,13,2001,2014,68,-123.843111,45.478028,"nitr"
"1934",13424,13,2001,2014,68,-123.735611,45.471806,"nitr"
"1935",13428,5,2007,2012,49,-123.843889,45.465278,"nitr"
"1936",13429,5,2007,2012,37,-123.809167,45.470833,"nitr"
"1937",13430,5,2007,2012,52,-123.844444,45.459167,"nitr"
"1938",13431,5,2007,2012,40,-123.85853,45.456389,"nitr"
"1939",13433,13,2001,2014,67,-123.822778,45.429861,"nitr"
"1940",13440,13,2001,2014,75,-123.824722,45.408611,"nitr"
"1941",13540,0,2006,2006,7,-124.192222,43.335556,"nitr"
"1942",13568,0,2009,2009,3,-124.023333,43.433056,"nitr"
"1943",13569,0,2009,2009,3,-124.030556,43.425,"nitr"
"1944",13570,13,2001,2014,85,-124.058583,43.405667,"nitr"
"1945",13574,13,2001,2014,71,-124.083083,43.363861,"nitr"
"1946",13583,1,2006,2007,17,-124.204083,43.325778,"nitr"
"1947",13632,0,2002,2002,1,-123.955556,45.890278,"nitr"
"1948",13781,0,2002,2002,5,-122.346389,42.378056,"nitr"
"1949",13782,1,2004,2005,8,-124.505139,42.896361,"nitr"
"1950",13787,0,2003,2003,2,-124.506778,42.75425,"nitr"
"1951",13959,0,2003,2003,8,-123.903056,46.084167,"nitr"
"1952",14008,13,2001,2014,36,-122.150861,45.162722,"nitr"
"1953",14018,9,2004,2013,70,-124.118972,43.548111,"nitr"
"1954",14182,0,2007,2007,1,-124.0585,44.6979,"nitr"
"1955",14183,0,2002,2002,1,-124.0595,44.697,"nitr"
"1956",14185,0,2002,2002,1,-124.0593,44.6967,"nitr"
"1957",14187,5,2002,2007,3,-124.0593,44.6963,"nitr"
"1958",14192,0,2002,2002,1,-124.058889,44.696111,"nitr"
"1959",14225,0,2011,2011,1,-122.736944,42.2625,"nitr"
"1960",14226,0,2011,2011,1,-122.732778,42.268889,"nitr"
"1961",14228,0,2011,2011,1,-122.735,42.261944,"nitr"
"1962",14240,8,2002,2010,3,-117.778611,44.708056,"nitr"
"1963",14241,8,2002,2010,6,-117.783056,44.706111,"nitr"
"1964",14242,8,2002,2010,5,-117.784167,44.706111,"nitr"
"1965",14243,8,2002,2010,5,-117.784167,44.704722,"nitr"
"1966",14244,5,2005,2010,2,-124.355833,43.202778,"nitr"
"1967",14246,5,2005,2010,2,-124.350556,43.207778,"nitr"
"1968",14247,5,2005,2010,2,-124.356111,43.2025,"nitr"
"1969",14248,5,2005,2010,2,-124.350833,43.208889,"nitr"
"1970",14249,5,2005,2010,4,-124.351944,43.206389,"nitr"
"1971",14254,0,2005,2005,1,-122.878889,45.851389,"nitr"
"1972",14255,0,2005,2005,1,-122.886111,45.850833,"nitr"
"1973",14256,0,2005,2005,1,-122.88,45.850556,"nitr"
"1974",14257,0,2005,2005,1,-122.881389,45.849722,"nitr"
"1975",14258,0,2005,2005,1,-122.879167,45.85,"nitr"
"1976",14259,0,2005,2005,2,-122.878889,45.849722,"nitr"
"1977",14260,0,2005,2005,1,-122.878333,45.849444,"nitr"
"1978",14263,0,2005,2005,1,-122.881667,45.85,"nitr"
"1979",14266,0,2002,2002,1,-124.316111,43.205278,"nitr"
"1980",14267,0,2005,2005,2,-124.316944,43.208611,"nitr"
"1981",14268,0,2009,2009,1,-124.316389,43.210278,"nitr"
"1982",14314,0,2002,2002,1,-123.081111,44.922778,"nitr"
"1983",14320,0,2002,2002,1,-123.078611,44.925833,"nitr"
"1984",14321,0,2002,2002,1,-123.078611,44.925833,"nitr"
"1985",14322,0,2002,2002,1,-123.078611,44.925833,"nitr"
"1986",14334,0,2002,2002,2,-123.091944,44.920833,"nitr"
"1987",14393,4,2002,2006,3,-123.94616,46.16115,"nitr"
"1988",14421,0,2001,2001,1,-122.948333,44.023056,"nitr"
"1989",14422,0,2001,2001,1,-122.945556,44.024167,"nitr"
"1990",14423,0,2001,2001,1,-122.945556,44.024167,"nitr"
"1991",14425,0,2009,2009,1,-123.232778,44.696667,"nitr"
"1992",14429,0,2006,2006,1,-123.236389,44.696667,"nitr"
"1993",14435,0,2006,2006,2,-123.246111,44.699444,"nitr"
"1994",14444,0,2006,2006,1,-123.239167,44.697222,"nitr"
"1995",14445,0,2009,2009,1,-123.239167,44.697222,"nitr"
"1996",14459,0,2006,2006,1,-123.225278,44.699722,"nitr"
"1997",14509,7,2001,2008,8,-120.287417,45.603194,"nitr"
"1998",14510,7,2001,2008,9,-120.295528,45.574944,"nitr"
"1999",14530,0,2011,2011,1,-121.519444,43.732222,"nitr"
"2000",14534,0,2011,2011,1,-121.458333,43.741389,"nitr"
"2001",14536,0,2011,2011,1,-121.461944,43.768611,"nitr"
"2002",14540,0,2011,2011,1,-121.433889,43.825833,"nitr"
"2003",14541,0,2011,2011,1,-121.433611,43.827778,"nitr"
"2004",14556,0,2011,2011,2,-121.591389,43.613056,"nitr"
"2005",14557,0,2011,2011,1,-121.574167,43.645833,"nitr"
"2006",14560,0,2011,2011,1,-121.566667,43.632222,"nitr"
"2007",14569,0,2011,2011,1,-121.603611,43.615278,"nitr"
"2008",14571,0,2011,2011,1,-121.505,43.646111,"nitr"
"2009",14573,0,2011,2011,1,-121.505556,43.647222,"nitr"
"2010",14575,0,2011,2011,1,-121.554444,43.675833,"nitr"
"2011",14578,0,2011,2011,1,-121.582778,43.700833,"nitr"
"2012",14579,0,2011,2011,2,-121.579722,43.684722,"nitr"
"2013",14585,0,2011,2011,1,-121.550833,43.697222,"nitr"
"2014",14592,0,2011,2011,1,-121.488339,43.716352,"nitr"
"2015",14593,0,2011,2011,1,-121.488611,43.734444,"nitr"
"2016",14594,0,2011,2011,1,-121.472222,43.734444,"nitr"
"2017",14596,0,2011,2011,1,-121.48,43.862778,"nitr"
"2018",14598,0,2011,2011,1,-121.481111,43.855833,"nitr"
"2019",14599,0,2011,2011,1,-121.506944,43.76,"nitr"
"2020",14600,0,2011,2011,2,-121.542222,43.7525,"nitr"
"2021",14619,0,2011,2011,2,-121.423333,43.822222,"nitr"
"2022",14623,0,2011,2011,1,-121.483056,43.783056,"nitr"
"2023",14627,0,2011,2011,1,-121.538889,43.740556,"nitr"
"2024",14632,0,2011,2011,1,-121.541389,43.744167,"nitr"
"2025",14635,0,2011,2011,1,-121.6043,43.6254,"nitr"
"2026",14638,0,2011,2011,2,-121.472,43.7328,"nitr"
"2027",14640,0,2011,2011,1,-121.561944,43.6175,"nitr"
"2028",14718,0,2011,2011,1,-121.569472,43.791944,"nitr"
"2029",14719,0,2011,2011,1,-121.573083,43.789722,"nitr"
"2030",14720,0,2011,2011,1,-121.545306,43.723889,"nitr"
"2031",14721,0,2011,2011,1,-121.5075,43.670278,"nitr"
"2032",14722,0,2011,2011,2,-121.514444,43.6775,"nitr"
"2033",14726,0,2011,2011,1,-121.426667,43.903333,"nitr"
"2034",14728,0,2011,2011,1,-121.554472,43.708611,"nitr"
"2035",14730,0,2011,2011,1,-121.540028,43.744444,"nitr"
"2036",14732,0,2003,2003,1,-122.768056,42.376667,"nitr"
"2037",14734,3,2003,2006,2,-122.774444,42.376111,"nitr"
"2038",14741,3,2003,2006,2,-122.770833,42.385556,"nitr"
"2039",14742,0,2009,2009,1,-122.771667,42.375833,"nitr"
"2040",14743,0,2003,2003,1,-122.773333,42.386667,"nitr"
"2041",14754,6,2005,2011,2,-122.588889,45.568056,"nitr"
"2042",14776,0,2003,2003,1,-122.447361,45.55875,"nitr"
"2043",14804,0,2004,2004,1,-122.806667,45.623056,"nitr"
"2044",14806,0,2004,2004,1,-122.811389,45.625833,"nitr"
"2045",14807,0,2004,2004,1,-122.806389,45.625833,"nitr"
"2046",14809,6,2002,2008,2,-119.581389,45.686389,"nitr"
"2047",14810,6,2002,2008,2,-119.586111,45.683611,"nitr"
"2048",14811,6,2002,2008,3,-119.580833,45.689722,"nitr"
"2049",14812,6,2002,2008,3,-119.583333,45.690556,"nitr"
"2050",14813,0,2002,2002,1,-119.601111,45.686389,"nitr"
"2051",14814,6,2002,2008,3,-119.591389,45.699722,"nitr"
"2052",14822,5,2007,2012,2,-124.116111,43.984167,"nitr"
"2053",14823,5,2007,2012,2,-124.118889,43.989167,"nitr"
"2054",14824,5,2007,2012,4,-124.113889,43.988333,"nitr"
"2055",14830,9,2004,2013,3,-120.21725,45.657917,"nitr"
"2056",14831,6,2004,2010,3,-120.223333,45.646778,"nitr"
"2057",14832,9,2004,2013,7,-120.204972,45.655528,"nitr"
"2058",14833,2,2004,2006,2,-120.209722,45.661611,"nitr"
"2059",14857,0,2011,2011,1,-123.271333,42.427333,"nitr"
"2060",14931,3,2002,2005,2,-122.976667,45.498056,"nitr"
"2061",14934,3,2002,2005,3,-122.969444,45.495,"nitr"
"2062",14939,3,2002,2005,3,-122.980278,45.494167,"nitr"
"2063",14940,3,2002,2005,2,-122.979444,45.495278,"nitr"
"2064",14941,0,2002,2002,1,-122.978889,45.497222,"nitr"
"2065",15009,7,2002,2009,3,-124.292222,43.316667,"nitr"
"2066",15011,0,2006,2006,1,-124.298056,43.321389,"nitr"
"2067",15012,7,2002,2009,3,-124.298056,43.317778,"nitr"
"2068",15013,7,2002,2009,2,-124.295833,43.319167,"nitr"
"2069",15015,0,2006,2006,1,-124.289167,43.318333,"nitr"
"2070",15016,0,2002,2002,1,-124.297778,43.319444,"nitr"
"2071",15020,0,2006,2006,1,-124.291111,43.316667,"nitr"
"2072",15039,10,2003,2013,2,-123.623611,42.214722,"nitr"
"2073",15116,9,2002,2011,3,-121.250278,44.013056,"nitr"
"2074",15117,0,2002,2002,1,-121.253889,44.012222,"nitr"
"2075",15118,0,2002,2002,1,-121.253056,44.008056,"nitr"
"2076",15119,6,2002,2008,3,-122.8725,45.409722,"nitr"
"2077",15120,8,2002,2010,3,-122.871944,45.407222,"nitr"
"2078",15121,0,2010,2010,1,-122.870833,45.408889,"nitr"
"2079",15123,6,2002,2008,4,-122.872778,45.408333,"nitr"
"2080",15124,0,2002,2002,1,-122.872778,45.408611,"nitr"
"2081",15125,0,2010,2010,1,-122.869167,45.408333,"nitr"
"2082",15144,13,2001,2014,65,-117.229167,43.988056,"nitr"
"2083",15151,13,2001,2014,69,-117.035,44.011,"nitr"
"2084",15155,13,2001,2014,63,-116.955,44.02,"nitr"
"2085",15169,13,2001,2014,70,-117.01,44.026,"nitr"
"2086",15174,12,2001,2013,67,-117.023,44.013,"nitr"
"2087",15180,13,2001,2014,66,-117.011,43.988,"nitr"
"2088",15183,13,2001,2014,69,-116.99,43.962,"nitr"
"2089",15186,13,2001,2014,73,-117.023,43.997,"nitr"
"2090",15201,12,2001,2013,27,-116.995,44.199,"nitr"
"2091",15203,13,2001,2014,63,-116.963,44.096,"nitr"
"2092",15216,13,2001,2014,61,-116.985,43.895,"nitr"
"2093",15217,12,2001,2013,70,-116.994,43.923,"nitr"
"2094",15221,13,2001,2014,64,-116.993,43.953,"nitr"
"2095",15229,13,2001,2014,75,-117.078,44.01,"nitr"
"2096",15233,13,2001,2014,71,-117.268861,43.967306,"nitr"
"2097",15234,12,2001,2013,42,-117.018,44.019,"nitr"
"2098",15236,13,2001,2014,76,-117.004,43.931,"nitr"
"2099",15244,13,2001,2014,44,-117.260194,44.026639,"nitr"
"2100",15249,13,2001,2014,68,-117.08,43.997,"nitr"
"2101",15253,12,2001,2013,65,-117.185,44.003,"nitr"
"2102",15254,12,2001,2013,53,-117.237,43.986,"nitr"
"2103",15257,13,2001,2014,66,-117.228,43.994,"nitr"
"2104",15264,13,2001,2014,75,-117.049944,43.995833,"nitr"
"2105",15275,13,2001,2014,53,-116.99,44.062,"nitr"
"2106",15280,12,2001,2013,32,-116.989,44.061,"nitr"
"2107",15284,10,2001,2011,43,-117.2925,43.909722,"nitr"
"2108",15289,13,2001,2014,64,-116.995,44.198333,"nitr"
"2109",15291,13,2001,2014,80,-117.175,44.136111,"nitr"
"2110",15294,13,2001,2014,67,-117.248333,43.966667,"nitr"
"2111",15302,12,2001,2013,44,-117.061111,43.992222,"nitr"
"2112",15327,12,2001,2013,22,-117.035278,44.010833,"nitr"
"2113",15328,13,2001,2014,75,-117.004167,44.230556,"nitr"
"2114",15329,13,2001,2014,69,-117.004194,43.894444,"nitr"
"2115",15330,6,2005,2011,2,-122.699167,45.591667,"nitr"
"2116",15331,6,2005,2011,2,-122.700833,45.591944,"nitr"
"2117",15361,4,2007,2011,3,-123.396944,42.501389,"nitr"
"2118",15363,4,2007,2011,2,-123.397222,42.501944,"nitr"
"2119",15387,4,2007,2011,2,-123.398056,42.504722,"nitr"
"2120",15446,0,2008,2008,1,-122.580833,45.5625,"nitr"
"2121",15450,6,2005,2011,2,-122.583889,45.563056,"nitr"
"2122",15451,3,2005,2008,3,-122.587278,45.566833,"nitr"
"2123",15452,6,2005,2011,5,-122.585806,45.566556,"nitr"
"2124",15453,6,2005,2011,3,-122.5845,45.566167,"nitr"
"2125",15499,0,2009,2009,2,-122.387778,45.525556,"nitr"
"2126",15500,0,2009,2009,1,-122.387778,45.523056,"nitr"
"2127",15508,0,2002,2002,2,-123.105556,44.601944,"nitr"
"2128",15509,0,2002,2002,1,-123.106389,44.601667,"nitr"
"2129",15510,0,2002,2002,1,-123.105,44.603056,"nitr"
"2130",15511,0,2002,2002,1,-123.106111,44.602778,"nitr"
"2131",15517,13,2001,2014,70,-117.155,43.796,"nitr"
"2132",15525,7,2001,2008,6,-117.055944,43.796,"nitr"
"2133",15538,13,2001,2014,71,-117.24425,43.643056,"nitr"
"2134",15540,13,2001,2014,67,-117.111111,43.780556,"nitr"
"2135",15541,13,2001,2014,65,-117.145833,43.786111,"nitr"
"2136",15542,7,2001,2008,2,-124.5075,42.771944,"nitr"
"2137",15543,5,2008,2013,4,-124.508889,42.769444,"nitr"
"2138",15546,7,2001,2008,3,-124.505,42.768611,"nitr"
"2139",15548,5,2008,2013,2,-124.508056,42.767778,"nitr"
"2140",15569,5,2008,2013,2,-124.071111,43.690833,"nitr"
"2141",15574,0,2008,2008,1,-124.068056,43.688333,"nitr"
"2142",15577,0,2013,2013,1,-124.07,43.688333,"nitr"
"2143",15578,5,2008,2013,2,-124.071389,43.690556,"nitr"
"2144",15598,0,2013,2013,2,-123.246139,45.158917,"nitr"
"2145",15607,0,2013,2013,1,-123.243611,45.163611,"nitr"
"2146",15611,6,2002,2008,2,-123.246944,45.157778,"nitr"
"2147",15612,0,2002,2002,1,-123.246944,45.158056,"nitr"
"2148",15615,11,2002,2013,3,-123.242222,45.160556,"nitr"
"2149",15617,0,2008,2008,1,-123.25,45.158056,"nitr"
"2150",15618,5,2008,2013,2,-123.249722,45.157778,"nitr"
"2151",15619,5,2008,2013,2,-123.243333,45.159444,"nitr"
"2152",15663,0,2011,2011,1,-123.419444,42.439722,"nitr"
"2153",15669,0,2011,2011,1,-123.271111,42.425278,"nitr"
"2154",15682,0,2011,2011,1,-122.830833,42.425278,"nitr"
"2155",15690,0,2011,2011,1,-122.9325,42.359444,"nitr"
"2156",15697,0,2006,2006,1,-123.3772,43.1847,"nitr"
"2157",15700,0,2006,2006,1,-123.3876,43.1851,"nitr"
"2158",15704,3,2006,2009,2,-123.378611,43.185833,"nitr"
"2159",15705,3,2006,2009,2,-123.378611,43.185833,"nitr"
"2160",15721,0,2006,2006,1,-123.365278,43.187222,"nitr"
"2161",15723,0,2006,2006,1,-123.376111,43.184722,"nitr"
"2162",15725,3,2006,2009,2,-123.377778,43.184722,"nitr"
"2163",15727,0,2009,2009,1,-123.380278,43.186389,"nitr"
"2164",15775,0,2013,2013,1,-123.004167,43.957222,"nitr"
"2165",15780,0,2013,2013,2,-123.002778,43.958611,"nitr"
"2166",15785,7,2006,2013,2,-123.012222,43.954444,"nitr"
"2167",15787,0,2013,2013,1,-123.005556,43.966944,"nitr"
"2168",15789,0,2013,2013,1,-122.997722,43.957,"nitr"
"2169",15791,0,2009,2009,1,-122.993472,43.956111,"nitr"
"2170",15796,0,2013,2013,1,-122.994444,43.958333,"nitr"
"2171",15798,0,2013,2013,1,-122.991639,43.955861,"nitr"
"2172",15801,0,2013,2013,1,-122.991944,43.955556,"nitr"
"2173",15834,0,2002,2002,1,-121.445,43.782778,"nitr"
"2174",15835,0,2002,2002,1,-121.446389,43.782778,"nitr"
"2175",15837,0,2002,2002,1,-121.444861,43.782778,"nitr"
"2176",15838,0,2002,2002,2,-121.444722,43.783056,"nitr"
"2177",15866,6,2003,2009,2,-122.949444,42.305833,"nitr"
"2178",15868,10,2003,2013,3,-122.954722,42.303889,"nitr"
"2179",15869,6,2003,2009,2,-122.953889,42.304444,"nitr"
"2180",15870,0,2003,2003,2,-122.954167,42.303611,"nitr"
"2181",15913,0,2011,2011,1,-122.759167,45.620833,"nitr"
"2182",15916,0,2011,2011,1,-122.761389,45.615833,"nitr"
"2183",15917,0,2008,2008,2,-122.761389,45.615833,"nitr"
"2184",15924,0,2011,2011,1,-122.745,45.613056,"nitr"
"2185",15935,0,2002,2002,1,-122.752333,45.618806,"nitr"
"2186",15936,6,2002,2008,2,-122.752333,45.618806,"nitr"
"2187",15937,0,2002,2002,1,-122.744167,45.615444,"nitr"
"2188",15938,6,2002,2008,2,-122.744167,45.615444,"nitr"
"2189",15940,0,2002,2002,1,-122.753889,45.618889,"nitr"
"2190",15941,6,2002,2008,3,-122.745306,45.605694,"nitr"
"2191",15942,0,2002,2002,1,-122.745306,45.605694,"nitr"
"2192",15947,0,2008,2008,1,-122.758611,45.618056,"nitr"
"2193",15949,0,2002,2002,1,-122.743889,45.614306,"nitr"
"2194",15968,0,2005,2005,1,-123.839722,45.416389,"nitr"
"2195",15970,0,2005,2005,1,-123.837222,45.416111,"nitr"
"2196",15971,0,2005,2005,1,-123.836111,45.417222,"nitr"
"2197",15972,0,2005,2005,1,-123.84,45.408889,"nitr"
"2198",15978,0,2005,2005,1,-123.836667,45.416667,"nitr"
"2199",15979,0,2005,2005,1,-123.836667,45.416667,"nitr"
"2200",15985,0,2005,2005,1,-123.852222,45.415556,"nitr"
"2201",15986,0,2005,2005,2,-123.85225,45.415556,"nitr"
"2202",15987,0,2005,2005,1,-123.851944,45.411667,"nitr"
"2203",15990,0,2005,2005,1,-123.847222,45.416389,"nitr"
"2204",16009,0,2009,2009,1,-119.67525,45.818722,"nitr"
"2205",16018,7,2001,2008,34,-119.6881,45.8296,"nitr"
"2206",16019,12,2001,2013,58,-119.7083,45.8194,"nitr"
"2207",16023,12,2001,2013,79,-119.5315,45.8973,"nitr"
"2208",16024,12,2001,2013,64,-119.5395,45.9023,"nitr"
"2209",16026,0,2009,2009,1,-119.504389,45.894417,"nitr"
"2210",16028,12,2001,2013,57,-119.3282,45.9196,"nitr"
"2211",16029,1,2001,2002,7,-119.2732,45.8651,"nitr"
"2212",16031,0,2009,2009,1,-119.237111,45.858139,"nitr"
"2213",16036,12,2001,2013,64,-119.221,45.8344,"nitr"
"2214",16037,12,2001,2013,64,-119.2252,45.7856,"nitr"
"2215",16038,12,2001,2013,69,-119.2168,45.7865,"nitr"
"2216",16046,12,2001,2013,70,-119.1537,45.8248,"nitr"
"2217",16047,0,2009,2009,1,-119.244611,45.885361,"nitr"
"2218",16048,3,2001,2004,19,-119.3098,45.7946,"nitr"
"2219",16049,0,2006,2006,1,-119.490833,45.8975,"nitr"
"2220",16055,0,2009,2009,1,-119.163889,45.917778,"nitr"
"2221",16056,1,2001,2002,6,-119.1711,45.9106,"nitr"
"2222",16063,0,2009,2009,1,-119.3325,45.812778,"nitr"
"2223",16069,0,2009,2009,1,-119.368889,45.783333,"nitr"
"2224",16070,0,2009,2009,1,-119.328333,45.785556,"nitr"
"2225",16074,12,2001,2013,57,-119.3209,45.8132,"nitr"
"2226",16075,6,2001,2007,27,-119.6429,45.8288,"nitr"
"2227",16076,0,2009,2009,2,-119.690833,45.844444,"nitr"
"2228",16078,1,2001,2002,7,NA,NA,"nitr"
"2229",16079,0,2009,2009,1,-119.314167,45.819167,"nitr"
"2230",16084,12,2001,2013,61,-119.353,45.8291,"nitr"
"2231",16086,12,2001,2013,67,-119.3817,45.9132,"nitr"
"2232",16093,12,2001,2013,70,-119.4396,45.9055,"nitr"
"2233",16096,12,2001,2013,67,-119.1896,45.8637,"nitr"
"2234",16099,12,2001,2013,70,-119.2194,45.8865,"nitr"
"2235",16100,12,2001,2013,67,-119.1641,45.8467,"nitr"
"2236",16102,12,2001,2013,71,-119.3884,45.7707,"nitr"
"2237",16106,12,2001,2013,65,-119.2115,45.8647,"nitr"
"2238",16109,12,2001,2013,71,-119.3151,45.8232,"nitr"
"2239",16112,4,2001,2005,24,-119.3268,45.7903,"nitr"
"2240",16113,0,2009,2009,1,-119.325556,45.784722,"nitr"
"2241",16114,0,2009,2009,2,-119.262778,45.820278,"nitr"
"2242",16122,0,2009,2009,1,-119.351944,45.843333,"nitr"
"2243",16123,12,2001,2013,65,-119.4351,45.7736,"nitr"
"2244",16126,0,2009,2009,1,-119.372778,45.821944,"nitr"
"2245",16128,0,2009,2009,1,-119.351667,45.848889,"nitr"
"2246",16134,12,2001,2013,62,-119.5065,45.8863,"nitr"
"2247",16146,12,2001,2013,75,-119.2396,45.8358,"nitr"
"2248",16150,12,2001,2013,57,-119.5597,45.8658,"nitr"
"2249",16151,0,2009,2009,2,-119.553333,45.888889,"nitr"
"2250",16153,0,2009,2009,1,-119.566944,45.918889,"nitr"
"2251",16154,11,2002,2013,62,-119.5067,45.8988,"nitr"
"2252",16158,12,2001,2013,65,-119.4756,45.8065,"nitr"
"2253",16164,0,2009,2009,1,-119.589167,45.876389,"nitr"
"2254",16167,0,2009,2009,1,-119.64,45.848889,"nitr"
"2255",16170,12,2001,2013,68,-119.5102,45.8747,"nitr"
"2256",16175,12,2001,2013,61,-119.343,45.7476,"nitr"
"2257",16176,0,2009,2009,1,-119.396111,45.71,"nitr"
"2258",16177,10,2001,2011,6,-119.3733,45.6978,"nitr"
"2259",16180,12,2001,2013,65,-119.1966,45.7317,"nitr"
"2260",16181,12,2001,2013,73,-119.2105,45.7586,"nitr"
"2261",16182,0,2009,2009,1,-119.240556,45.747778,"nitr"
"2262",16184,0,2009,2009,1,-119.540278,45.776389,"nitr"
"2263",16188,12,2001,2013,69,-119.3728,45.8463,"nitr"
"2264",16191,12,2001,2013,66,-119.6539,45.8509,"nitr"
"2265",16198,0,2009,2009,1,-119.398139,45.852972,"nitr"
"2266",16208,0,2010,2010,1,-119.453083,45.851944,"nitr"
"2267",16209,0,2009,2009,1,-119.389944,45.8495,"nitr"
"2268",16212,0,2009,2009,1,-119.397056,45.846083,"nitr"
"2269",16214,0,2010,2010,1,-119.428472,45.828583,"nitr"
"2270",16215,0,2010,2010,1,-119.428639,45.828639,"nitr"
"2271",16218,0,2010,2010,1,-119.438278,45.837306,"nitr"
"2272",16221,0,2009,2009,1,-119.602278,45.858361,"nitr"
"2273",16222,0,2009,2009,1,-119.620583,45.848278,"nitr"
"2274",16223,0,2009,2009,1,-119.623583,45.807,"nitr"
"2275",16224,0,2009,2009,1,-119.380472,45.858,"nitr"
"2276",16225,0,2009,2009,1,-119.372139,45.864,"nitr"
"2277",16226,0,2009,2009,1,-119.357778,45.858306,"nitr"
"2278",16227,0,2009,2009,1,-119.359806,45.858278,"nitr"
"2279",16228,0,2009,2009,2,-119.378694,45.857972,"nitr"
"2280",16229,0,2009,2009,1,-119.383139,45.769639,"nitr"
"2281",16230,0,2009,2009,1,-119.439139,45.748167,"nitr"
"2282",16231,0,2009,2009,1,-119.407139,45.730306,"nitr"
"2283",16232,0,2009,2009,1,-119.347833,45.740917,"nitr"
"2284",16233,0,2009,2009,1,-119.358056,45.864083,"nitr"
"2285",16234,0,2009,2009,1,-119.232611,45.780722,"nitr"
"2286",16235,0,2009,2009,1,-119.315528,45.797139,"nitr"
"2287",16236,0,2009,2009,1,-119.315167,45.792972,"nitr"
"2288",16237,0,2010,2010,1,-119.315167,45.792972,"nitr"
"2289",16240,0,2009,2009,1,-119.301722,45.792611,"nitr"
"2290",16241,0,2009,2009,1,-119.331167,45.768917,"nitr"
"2291",16242,0,2010,2010,1,-119.32175,45.773611,"nitr"
"2292",16243,0,2009,2009,1,-119.310139,45.762861,"nitr"
"2293",16244,0,2009,2009,1,-119.363583,45.737278,"nitr"
"2294",16245,0,2010,2010,1,-119.351444,45.759278,"nitr"
"2295",16248,0,2010,2010,1,-119.293472,45.794167,"nitr"
"2296",16249,0,2009,2009,1,-119.232583,45.781,"nitr"
"2297",16250,0,2009,2009,1,-119.226333,45.782806,"nitr"
"2298",16251,0,2009,2009,2,-119.315528,45.797167,"nitr"
"2299",16252,0,2009,2009,1,-119.226583,45.782861,"nitr"
"2300",16253,0,2009,2009,1,-119.225083,45.806333,"nitr"
"2301",16254,0,2009,2009,2,-119.235694,45.82025,"nitr"
"2302",16255,0,2009,2009,1,-119.224694,45.820056,"nitr"
"2303",16256,0,2010,2010,1,-119.473528,45.897889,"nitr"
"2304",16257,0,2010,2010,1,-119.474639,45.898944,"nitr"
"2305",16258,0,2010,2010,1,-119.475972,45.900028,"nitr"
"2306",16261,0,2010,2010,1,-119.870833,45.704333,"nitr"
"2307",16263,0,2010,2010,2,-119.833306,45.720694,"nitr"
"2308",16264,0,2010,2010,1,-119.866194,45.795611,"nitr"
"2309",16272,10,2003,2013,3,-124.0715,44.3995,"nitr"
"2310",16273,10,2003,2013,3,-124.0711,44.4013,"nitr"
"2311",16275,10,2003,2013,5,-124.0711,44.3999,"nitr"
"2312",16276,10,2003,2013,3,-124.0709,44.3999,"nitr"
"2313",16278,0,2003,2003,1,-124.071,44.3998,"nitr"
"2314",16280,10,2003,2013,4,-124.0686,44.4024,"nitr"
"2315",16534,0,2009,2009,1,-123.221111,44.233611,"nitr"
"2316",16537,7,2002,2009,4,-123.219444,44.25,"nitr"
"2317",16545,7,2002,2009,4,-123.245,44.25249,"nitr"
"2318",16553,7,2002,2009,4,-123.18777,44.207779,"nitr"
"2319",16591,0,2009,2009,1,-122.991667,44.590556,"nitr"
"2320",16649,0,2009,2009,1,-123.12355,44.18477,"nitr"
"2321",16650,0,2009,2009,1,-123.12949,44.18862,"nitr"
"2322",16655,0,2009,2009,1,-123.12239,44.18861,"nitr"
"2323",16656,4,2002,2006,3,-123.0744,44.13537,"nitr"
"2324",16658,7,2002,2009,3,-123.0946,44.13508,"nitr"
"2325",16660,7,2002,2009,5,-123.0974,44.14236,"nitr"
"2326",16677,0,2001,2001,1,-122.856389,45.174167,"nitr"
"2327",16696,0,2001,2001,1,-122.859167,45.178611,"nitr"
"2328",16697,1,2003,2004,3,-122.855556,45.178056,"nitr"
"2329",16699,0,2001,2001,1,-122.859083,45.173389,"nitr"
"2330",16701,9,2001,2010,5,-122.860556,45.179444,"nitr"
"2331",16705,0,2010,2010,1,-122.856389,45.180833,"nitr"
"2332",16708,0,2001,2001,1,-122.858889,45.174444,"nitr"
"2333",16709,0,2001,2001,1,-122.858056,45.173333,"nitr"
"2334",16718,0,2011,2011,2,-122.7325,42.263611,"nitr"
"2335",16719,0,2011,2011,1,-122.736389,42.262778,"nitr"
"2336",16721,0,2011,2011,1,-122.736111,42.261389,"nitr"
"2337",16727,7,2002,2009,4,-124.318333,43.209167,"nitr"
"2338",16732,3,2003,2006,2,-123.112778,44.098333,"nitr"
"2339",16733,3,2003,2006,2,-123.106667,44.1075,"nitr"
"2340",16734,3,2003,2006,2,-123.106111,44.107778,"nitr"
"2341",16737,3,2003,2006,3,-123.108611,44.104167,"nitr"
"2342",16738,3,2003,2006,3,-123.111111,44.100556,"nitr"
"2343",16739,3,2006,2009,2,-122.771111,42.383333,"nitr"
"2344",16740,3,2003,2006,2,-122.771389,42.383611,"nitr"
"2345",16741,0,2006,2006,1,-122.772222,42.383333,"nitr"
"2346",16742,0,2007,2007,1,-123.3382,43.3371,"nitr"
"2347",16743,0,2007,2007,1,-123.337778,43.335833,"nitr"
"2348",16754,4,2002,2006,3,-124.297222,43.318333,"nitr"
"2349",16756,0,2002,2002,1,-124.298333,43.318889,"nitr"
"2350",16757,10,2003,2013,4,-123.624722,42.213611,"nitr"
"2351",16758,10,2003,2013,2,-123.625,42.215556,"nitr"
"2352",16759,7,2004,2011,5,-121.747778,42.236111,"nitr"
"2353",16760,4,2004,2008,4,-121.747778,42.233056,"nitr"
"2354",16761,0,2006,2006,1,-121.751667,42.2325,"nitr"
"2355",16762,0,2006,2006,1,-121.754722,42.232222,"nitr"
"2356",16772,10,2003,2013,3,-122.952778,42.305556,"nitr"
"2357",16997,0,2005,2005,1,-120.860444,44.301972,"nitr"
"2358",17164,0,2002,2002,1,-122.857361,42.963389,"nitr"
"2359",18774,0,2001,2001,1,-124.105528,44.265667,"nitr"
"2360",18775,0,2001,2001,1,-123.845472,44.319833,"nitr"
"2361",18789,0,2002,2002,1,-123.611389,42.80375,"nitr"
"2362",18796,0,2001,2001,1,-123.7928,44.7456,"nitr"
"2363",18797,0,2001,2001,1,-123.9003,45.1404,"nitr"
"2364",18802,0,2001,2001,1,-123.769111,45.813472,"nitr"
"2365",18803,0,2001,2001,2,-123.765083,43.806222,"nitr"
"2366",18804,0,2001,2001,1,-124.10825,44.224194,"nitr"
"2367",18821,5,2003,2008,7,-124.427583,42.965917,"nitr"
"2368",18822,5,2003,2008,8,-124.414333,43.003361,"nitr"
"2369",18823,5,2003,2008,15,-124.41375,43.052083,"nitr"
"2370",18824,4,2003,2007,5,-124.423417,42.975472,"nitr"
"2371",20391,0,2005,2005,1,-124.067333,42.8885,"nitr"
"2372",20392,0,2005,2005,1,-124.06725,42.88875,"nitr"
"2373",20394,6,2005,2011,7,-124.067417,42.888111,"nitr"
"2374",20422,6,2002,2008,3,-119.308333,45.886111,"nitr"
"2375",20423,4,2002,2006,4,-119.305278,45.886111,"nitr"
"2376",20424,0,2002,2002,1,-119.309722,45.89,"nitr"
"2377",20447,7,2004,2011,11,-124.096472,43.595028,"nitr"
"2378",21535,3,2011,2014,6,-121.500333,42.462,"nitr"
"2379",21790,0,2002,2002,2,-123.979761,44.499656,"nitr"
"2380",21791,5,2002,2007,6,-124.105811,44.170708,"nitr"
"2381",21792,0,2003,2003,2,-123.92875,44.580669,"nitr"
"2382",21794,3,2002,2005,3,-124.305169,42.804089,"nitr"
"2383",21797,2,2003,2005,2,-124.185911,42.974633,"nitr"
"2384",21799,0,2002,2002,1,-124.029111,42.768633,"nitr"
"2385",21800,2,2011,2013,14,-123.55045,45.277942,"nitr"
"2386",21804,3,2002,2005,3,-123.621869,45.228936,"nitr"
"2387",21805,3,2002,2005,3,-123.830931,45.351989,"nitr"
"2388",21806,0,2002,2002,1,-123.822639,45.284822,"nitr"
"2389",21807,0,2002,2002,2,-123.8835,45.912014,"nitr"
"2390",21811,3,2002,2005,5,-123.51585,45.585806,"nitr"
"2391",21812,0,2002,2002,1,-123.490039,45.552708,"nitr"
"2392",21813,0,2002,2002,2,-123.284581,45.736719,"nitr"
"2393",21814,4,2001,2005,2,-123.91125,42.174153,"nitr"
"2394",21818,2,2012,2014,17,-122.845169,44.704356,"nitr"
"2395",21822,3,2002,2005,5,-123.238861,42.101917,"nitr"
"2396",21832,0,2002,2002,2,-122.251917,44.437386,"nitr"
"2397",21833,0,2002,2002,1,-122.736606,44.258794,"nitr"
"2398",21835,4,2001,2005,3,-122.101831,44.782844,"nitr"
"2399",21839,3,2002,2005,5,-122.889283,43.740583,"nitr"
"2400",21841,0,2002,2002,1,-123.125125,45.508128,"nitr"
"2401",21842,1,2007,2008,3,-123.851073,44.538726,"nitr"
"2402",21848,0,2007,2007,1,-123.979692,42.045169,"nitr"
"2403",21849,0,2007,2007,1,-124.034286,42.573014,"nitr"
"2404",22369,0,2011,2011,3,-123.706519,45.277064,"nitr"
"2405",22375,2,2011,2013,12,-123.603114,45.239361,"nitr"
"2406",22383,2,2011,2013,14,-123.580667,45.265833,"nitr"
"2407",22386,0,2008,2008,1,-123.168453,45.436233,"nitr"
"2408",22394,2,2011,2013,13,-123.818167,45.2765,"nitr"
"2409",22569,2,2001,2003,12,-121.464178,43.824022,"nitr"
"2410",22571,0,2002,2002,1,-121.464156,43.824003,"nitr"
"2411",22572,2,2001,2003,23,-121.464147,43.823897,"nitr"
"2412",22573,2,2001,2003,10,-121.464156,43.823744,"nitr"
"2413",22574,2,2001,2003,9,-121.464642,43.823903,"nitr"
"2414",22651,0,2006,2006,1,-122.7605,44.254167,"nitr"
"2415",22654,0,2006,2006,2,-122.854083,44.172861,"nitr"
"2416",22667,0,2002,2002,1,-124.243419,43.436939,"nitr"
"2417",22668,0,2002,2002,1,-124.238749,43.43694,"nitr"
"2418",22669,0,2002,2002,1,-124.244882,43.436594,"nitr"
"2419",22670,0,2002,2002,1,-124.243561,43.436594,"nitr"
"2420",22671,0,2002,2002,1,-124.240966,43.436422,"nitr"
"2421",22672,4,2002,2006,2,-124.241013,43.436491,"nitr"
"2422",22673,0,2002,2002,1,-124.24587,43.434834,"nitr"
"2423",22674,4,2002,2006,2,-124.244879,43.434282,"nitr"
"2424",22675,0,2006,2006,2,-124.243888,43.434351,"nitr"
"2425",22676,0,2004,2004,1,-123.426725,43.103019,"nitr"
"2426",22677,0,2004,2004,1,-123.426539,43.100265,"nitr"
"2427",22678,9,2004,2013,2,-123.426539,43.098648,"nitr"
"2428",22679,0,2004,2004,1,-123.426304,43.099508,"nitr"
"2429",22680,9,2004,2013,2,-123.426256,43.102881,"nitr"
"2430",22683,0,2002,2002,1,-122.744444,45.612222,"nitr"
"2431",22684,5,2005,2010,3,-121.136719,45.560133,"nitr"
"2432",22685,5,2005,2010,3,-121.138153,45.563756,"nitr"
"2433",22687,0,2007,2007,1,-121.130381,45.561053,"nitr"
"2434",22689,2,2005,2007,3,-121.141683,45.561742,"nitr"
"2435",22691,0,2010,2010,2,-121.141272,45.565861,"nitr"
"2436",22692,0,2005,2005,1,-122.699583,45.593611,"nitr"
"2437",22696,6,2006,2012,3,-118.475833,45.9575,"nitr"
"2438",22697,6,2006,2012,4,-118.480833,45.961667,"nitr"
"2439",22698,6,2006,2012,5,-118.483333,45.958056,"nitr"
"2440",22699,4,2002,2006,3,-121.251389,44.010556,"nitr"
"2441",22700,9,2002,2011,2,-121.258889,44.010278,"nitr"
"2442",22701,5,2006,2011,3,-121.446111,43.782778,"nitr"
"2443",22702,2,2006,2008,2,-121.445,43.781667,"nitr"
"2444",22705,5,2006,2011,3,-121.444722,43.782222,"nitr"
"2445",22715,0,2002,2002,1,-122.995,44.900278,"nitr"
"2446",22716,4,2002,2006,3,-122.998056,44.901389,"nitr"
"2447",22719,7,2002,2009,4,-122.993889,44.897222,"nitr"
"2448",22721,6,2003,2009,3,-122.770278,42.386111,"nitr"
"2449",22931,9,2002,2011,4,-123.366278,46.031611,"nitr"
"2450",22965,0,2005,2005,2,-121.495472,45.651611,"nitr"
"2451",22966,0,2005,2005,1,-121.495667,45.651639,"nitr"
"2452",22970,0,2005,2005,2,-121.543528,45.635028,"nitr"
"2453",22971,0,2005,2005,1,-121.534306,45.628639,"nitr"
"2454",22972,0,2005,2005,2,-121.530056,45.627278,"nitr"
"2455",22973,0,2005,2005,2,-121.529611,45.627278,"nitr"
"2456",22974,0,2005,2005,2,-121.528,45.627278,"nitr"
"2457",22978,0,2005,2005,2,-121.518778,45.638889,"nitr"
"2458",22985,0,2005,2005,1,-118.84027,45.668152,"nitr"
"2459",22986,0,2005,2005,1,-118.84195,45.66786,"nitr"
"2460",23038,0,2005,2005,1,-118.83934,45.66825,"nitr"
"2461",23160,4,2004,2008,2,-123.098056,43.303056,"nitr"
"2462",23162,0,2004,2004,1,-123.100556,43.305,"nitr"
"2463",23163,0,2008,2008,1,-123.099444,43.305556,"nitr"
"2464",23172,3,2001,2004,5,-122.86916,45.181111,"nitr"
"2465",23176,1,2003,2004,2,-122.86,45.181667,"nitr"
"2466",23195,13,2001,2014,65,-116.995,44.198333,"nitr"
"2467",23196,2,2006,2008,2,-118.116667,45.3525,"nitr"
"2468",23197,6,2002,2008,3,-118.121667,45.348333,"nitr"
"2469",23198,6,2002,2008,5,-118.121944,45.347778,"nitr"
"2470",23202,0,2002,2002,1,-118.121806,45.347917,"nitr"
"2471",23242,0,2001,2001,2,-123.95,44.020833,"nitr"
"2472",23260,4,2007,2011,3,-123.39694,42.498055,"nitr"
"2473",23321,0,2011,2011,1,-121.55307,43.68474,"nitr"
"2474",23402,0,2002,2002,1,-123.999406,42.454753,"nitr"
"2475",23408,0,2002,2002,1,-124.037414,42.514094,"nitr"
"2476",23438,0,2011,2011,1,-121.4952778,43.700833,"nitr"
"2477",23443,0,2011,2011,1,-121.4653,43.86283,"nitr"
"2478",23445,0,2011,2011,1,-121.47556,43.70802,"nitr"
"2479",23487,0,2005,2005,14,-118.165106,45.829289,"nitr"
"2480",23492,0,2005,2005,13,-118.333181,45.900972,"nitr"
"2481",23509,1,2012,2013,16,-123.589979,45.84384,"nitr"
"2482",23737,13,2001,2014,65,-116.99405,44.242883,"nitr"
"2483",23753,6,2003,2009,25,-124.407222,42.371944,"nitr"
"2484",23761,5,2003,2008,11,-124.494653,42.764017,"nitr"
"2485",23769,2,2012,2014,21,-122.8045,44.65808,"nitr"
"2486",23770,2,2012,2014,18,-122.8549,44.63358,"nitr"
"2487",23775,2,2012,2014,17,-122.7979,44.51356,"nitr"
"2488",23778,2,2012,2014,15,-122.7676,44.46067,"nitr"
"2489",23785,2,2012,2014,17,-122.8588,44.70381,"nitr"
"2490",23797,2,2001,2003,13,-122.826317,45.970117,"nitr"
"2491",23800,2,2001,2003,13,-123.4242,46.220683,"nitr"
"2492",23815,0,2003,2003,1,-123.846842,45.897376,"nitr"
"2493",23816,0,2003,2003,1,-123.754676,45.545668,"nitr"
"2494",23819,0,2003,2003,1,-123.488,45.4743,"nitr"
"2495",23821,0,2003,2003,1,-123.68697,44.197048,"nitr"
"2496",23823,0,2003,2003,1,-123.9838,44.085856,"nitr"
"2497",23836,3,2002,2005,4,-123.39559,42.781741,"nitr"
"2498",23837,3,2002,2005,4,-123.60948,43.45645,"nitr"
"2499",23839,0,2003,2003,1,-123.20991,42.602606,"nitr"
"2500",23840,0,2007,2007,2,-123.5701,42.655431,"nitr"
"2501",23847,4,2001,2005,4,-122.3852,44.427415,"nitr"
"2502",23853,0,2003,2003,1,-123.350797,45.173487,"nitr"
"2503",23854,0,2003,2003,1,-123.55147,45.000534,"nitr"
"2504",23857,0,2003,2003,1,-122.677977,43.620848,"nitr"
"2505",23859,2,2001,2003,21,-123.393163,44.265533,"nitr"
"2506",23863,0,2007,2007,2,-123.311606,44.415841,"nitr"
"2507",23892,2,2005,2007,8,-122.99812,43.32422,"nitr"
"2508",23897,2,2005,2007,3,-122.54524,43.29207,"nitr"
"2509",23930,0,2006,2006,1,-124.498122,42.91153,"nitr"
"2510",23931,1,2006,2007,4,-124.49281,42.91442,"nitr"
"2511",24037,0,2003,2003,2,-123.918611,46.128611,"nitr"
"2512",24090,5,2003,2008,8,-124.31929,42.94343,"nitr"
"2513",24091,5,2003,2008,8,-124.3339,42.94921,"nitr"
"2514",24135,0,2012,2012,2,-118.47266,44.798083,"nitr"
"2515",24174,0,2003,2003,1,-123.9071,46.0851,"nitr"
"2516",24295,0,2003,2003,1,-123.90767,46.09176,"nitr"
"2517",24341,11,2002,2013,13,-117.0573,43.795233,"nitr"
"2518",24344,0,2005,2005,1,NA,NA,"nitr"
"2519",24364,2,2001,2003,10,-121.493611,43.700556,"nitr"
"2520",24365,0,2002,2002,1,-121.493611,43.707222,"nitr"
"2521",24366,2,2001,2003,9,-121.498333,43.706389,"nitr"
"2522",24367,0,2002,2002,1,-121.485556,43.704444,"nitr"
"2523",24368,2,2001,2003,9,-121.496667,43.710556,"nitr"
"2524",24369,2,2001,2003,8,-121.498056,43.713611,"nitr"
"2525",24370,1,2002,2003,7,-121.465278,43.706389,"nitr"
"2526",24371,1,2002,2003,5,-121.460278,43.706389,"nitr"
"2527",24372,1,2002,2003,8,-121.460833,43.791667,"nitr"
"2528",24373,2,2001,2003,9,-121.464583,43.792833,"nitr"
"2529",24374,2,2001,2003,7,-121.464583,43.792389,"nitr"
"2530",24375,2,2001,2003,9,-121.463972,43.792694,"nitr"
"2531",24376,1,2002,2003,7,-121.458611,43.798611,"nitr"
"2532",24377,2,2001,2003,9,-121.458611,43.799722,"nitr"
"2533",24379,0,2003,2003,4,-121.83316,43.82444,"nitr"
"2534",24380,2,2001,2003,8,-121.459543,43.831395,"nitr"
"2535",24381,1,2001,2002,2,-121.459194,43.830616,"nitr"
"2536",24382,2,2001,2003,26,-121.464052,43.792862,"nitr"
"2537",24391,0,2005,2005,1,-122.86306,45.84076,"nitr"
"2538",24488,5,2002,2007,4,-123.93222,44.60538,"nitr"
"2539",24489,9,2002,2011,5,-123.93369,44.60559,"nitr"
"2540",24491,0,2002,2002,1,-123.9316,44.6049,"nitr"
"2541",24492,9,2002,2011,5,-123.92233,44.60043,"nitr"
"2542",24501,2,2001,2003,7,-121.53731,43.69052,"nitr"
"2543",24503,1,2001,2002,2,-121.47607,43.70743,"nitr"
"2544",24504,2,2001,2003,9,-121.47622,43.70785,"nitr"
"2545",24505,2,2001,2003,10,-121.47728,43.70758,"nitr"
"2546",24506,2,2001,2003,7,-121.51961,43.70975,"nitr"
"2547",24508,0,2002,2002,2,-121.51908,43.71014,"nitr"
"2548",24509,2,2001,2003,8,-121.51677,43.7125,"nitr"
"2549",24510,2,2001,2003,8,-121.51719,43.71291,"nitr"
"2550",24511,2,2001,2003,6,-121.516065,43.712903,"nitr"
"2551",24512,3,2001,2004,9,-121.50083,43.71306,"nitr"
"2552",24513,3,2001,2004,9,-121.50056,43.71333,"nitr"
"2553",24517,2,2001,2003,8,-121.50023,43.74202,"nitr"
"2554",24518,2,2001,2003,8,-121.50044,43.74362,"nitr"
"2555",24519,2,2001,2003,8,-121.49929,43.74364,"nitr"
"2556",24548,5,2005,2010,3,-121.13755,45.56747,"nitr"
"2557",24561,0,2009,2009,1,-123.37976,43.18707,"nitr"
"2558",24562,0,2009,2009,1,-123.37969,43.18703,"nitr"
"2559",24566,0,2013,2013,2,-121.05479,45.63068,"nitr"
"2560",24574,2,2012,2014,16,-122.946444,44.735333,"nitr"
"2561",24576,1,2002,2003,8,-121.48088,43.83669,"nitr"
"2562",24578,2,2001,2003,13,-121.494631,43.730308,"nitr"
"2563",24580,2,2001,2003,17,-121.494496,43.730231,"nitr"
"2564",24581,2,2001,2003,14,-121.494503,43.730204,"nitr"
"2565",24582,2,2001,2003,12,-121.464119,43.792859,"nitr"
"2566",24585,2,2001,2003,13,-121.463913,43.792493,"nitr"
"2567",24586,2,2001,2003,18,-121.463982,43.793019,"nitr"
"2568",24590,0,2009,2009,2,-123.16316,44.33209,"nitr"
"2569",24592,7,2002,2009,3,-123.12846,44.3158,"nitr"
"2570",24597,2,2001,2003,16,-121.459773,43.794534,"nitr"
"2571",24598,2,2001,2003,12,-121.459472,43.794677,"nitr"
"2572",24599,2,2001,2003,13,-121.465437,43.821942,"nitr"
"2573",24600,2,2001,2003,19,-121.465284,43.821938,"nitr"
"2574",24601,2,2001,2003,13,-121.465281,43.821642,"nitr"
"2575",24604,4,2002,2006,2,-122.92536,44.61331,"nitr"
"2576",24607,2,2001,2003,29,-121.521171,43.70068,"nitr"
"2577",24608,2,2001,2003,17,-121.477183,43.707738,"nitr"
"2578",24609,2,2001,2003,15,-121.478097,43.715172,"nitr"
"2579",24610,1,2001,2002,4,-121.519353,43.709913,"nitr"
"2580",24611,3,2001,2004,35,-121.516251,43.712803,"nitr"
"2581",24612,2,2001,2003,20,-121.45929,43.830933,"nitr"
"2582",24613,2,2001,2003,10,-121.499226,43.743467,"nitr"
"2583",24614,2,2001,2003,26,-121.497529,43.702649,"nitr"
"2584",24615,1,2002,2003,12,-121.461357,43.790607,"nitr"
"2585",24616,2,2001,2003,8,-121.460158,43.830648,"nitr"
"2586",24617,2,2001,2003,14,-121.459385,43.831098,"nitr"
"2587",24618,2,2001,2003,16,-121.459356,43.831066,"nitr"
"2588",24619,2,2001,2003,18,-121.459337,43.831026,"nitr"
"2589",24621,2,2001,2003,10,-121.569532,43.639586,"nitr"
"2590",24622,2,2001,2003,12,-121.569551,43.640423,"nitr"
"2591",24623,2,2001,2003,9,-121.569551,43.64045,"nitr"
"2592",24625,2,2001,2003,9,-121.568061,43.640232,"nitr"
"2593",24627,2,2001,2003,15,-121.568106,43.640269,"nitr"
"2594",24628,2,2001,2003,15,-121.568306,43.640127,"nitr"
"2595",24630,1,2002,2003,6,-121.547567,43.702176,"nitr"
"2596",24631,2,2001,2003,9,-121.54643,43.702207,"nitr"
"2597",24632,2,2001,2003,10,-121.547207,43.701535,"nitr"
"2598",24633,2,2002,2004,15,-121.547263,43.701555,"nitr"
"2599",24634,3,2001,2004,23,-121.547058,43.701781,"nitr"
"2600",24635,2,2001,2003,11,-121.522216,43.700471,"nitr"
"2601",24636,2,2001,2003,10,-121.522209,43.701174,"nitr"
"2602",24637,2,2001,2003,10,-121.52121,43.701268,"nitr"
"2603",24639,2,2001,2003,14,-121.521416,43.700597,"nitr"
"2604",24641,2,2001,2003,16,-121.521494,43.700592,"nitr"
"2605",24642,2,2001,2003,15,-121.521424,43.700947,"nitr"
"2606",24643,3,2001,2004,23,-121.519032,43.709907,"nitr"
"2607",24644,2,2002,2004,20,-121.519575,43.709905,"nitr"
"2608",24645,2,2002,2004,14,-121.516173,43.712769,"nitr"
"2609",24646,3,2001,2004,20,-121.517581,43.712739,"nitr"
"2610",24648,0,2001,2001,1,-121.460742,43.790434,"nitr"
"2611",24649,0,2001,2001,2,-121.459396,43.831094,"nitr"
"2612",24651,0,2009,2009,1,-123.21353,44.5791,"nitr"
"2613",24655,2,2001,2003,15,-121.497325,43.702543,"nitr"
"2614",24656,2,2001,2003,17,-121.49733,43.702518,"nitr"
"2615",24657,2,2001,2003,30,-121.497359,43.702491,"nitr"
"2616",24659,2,2001,2003,13,-121.476727,43.707493,"nitr"
"2617",24661,2,2001,2003,8,-121.478107,43.714898,"nitr"
"2618",24663,2,2001,2003,8,-121.478113,43.715387,"nitr"
"2619",24664,2,2001,2003,13,-121.477723,43.714997,"nitr"
"2620",24665,2,2001,2003,14,-121.495002,43.729247,"nitr"
"2621",24666,2,2001,2003,15,-121.49539,43.729411,"nitr"
"2622",24667,2,2001,2003,18,-121.495338,43.729463,"nitr"
"2623",24668,2,2001,2003,11,-121.4598,43.794643,"nitr"
"2624",24669,2,2001,2003,9,-121.477374,43.715312,"nitr"
"2625",24670,2,2001,2003,8,-121.465205,43.821748,"nitr"
"2626",24671,2,2001,2003,9,-121.465179,43.821325,"nitr"
"2627",24672,2,2001,2003,9,-121.465463,43.821476,"nitr"
"2628",24673,2,2001,2003,12,-121.460764,43.79042,"nitr"
"2629",24674,2,2001,2003,14,-121.4608,43.790426,"nitr"
"2630",24675,2,2001,2003,18,-121.460854,43.790442,"nitr"
"2631",24676,10,2002,2012,4,-121.80452,42.17722,"nitr"
"2632",24678,10,2002,2012,5,-121.80387,42.17511,"nitr"
"2633",24679,10,2002,2012,3,-121.80475,42.1743,"nitr"
"2634",24682,0,2001,2001,2,-121.497326,43.702575,"nitr"
"2635",24683,2,2001,2003,14,-121.464178,43.824022,"nitr"
"2636",24685,7,2002,2009,4,-123.1973,44.63145,"nitr"
"2637",24690,2,2001,2003,14,-121.500523,43.742338,"nitr"
"2638",24692,2,2001,2003,14,-121.500523,43.742372,"nitr"
"2639",24696,0,2009,2009,2,-123.10714,44.54058,"nitr"
"2640",24701,0,2009,2009,2,-123.10284,44.53886,"nitr"
"2641",24712,0,2009,2009,1,-122.96089,44.6669,"nitr"
"2642",24728,0,2002,2002,1,-122.95059,44.7079,"nitr"
"2643",24736,0,2009,2009,1,-123.18527,44.51069,"nitr"
"2644",24738,7,2002,2009,3,-123.2099,44.40309,"nitr"
"2645",24739,0,2009,2009,1,-123.20382,44.4415,"nitr"
"2646",10085,1,2002,2003,2,-123.049056,43.808556,"phos"
"2647",10086,2,2001,2003,2,-123.253139,44.921472,"phos"
"2648",10087,4,2002,2006,3,-122.709167,42.211111,"phos"
"2649",10151,2,2001,2003,21,-123.268611,44.005278,"phos"
"2650",10332,11,2001,2012,67,-122.7475,45.577944,"phos"
"2651",10339,11,2001,2012,87,-122.690722,45.300333,"phos"
"2652",10342,10,2001,2011,21,-122.942361,45.267639,"phos"
"2653",10344,11,2001,2012,54,-123.044306,45.090583,"phos"
"2654",10350,11,2001,2012,105,-123.105778,44.639722,"phos"
"2655",10352,11,2001,2012,124,-123.255417,44.565528,"phos"
"2656",10355,11,2001,2012,109,-123.173667,44.267167,"phos"
"2657",10359,11,2001,2012,59,-123.02675,44.045611,"phos"
"2658",10363,11,2001,2012,85,-123.071583,45.223639,"phos"
"2659",10366,11,2001,2012,63,-122.923556,44.636194,"phos"
"2660",10373,11,2001,2012,67,-123.263639,44.556639,"phos"
"2661",10376,11,2001,2012,60,-123.046194,44.112722,"phos"
"2662",10386,11,2001,2012,58,-122.905278,43.998194,"phos"
"2663",10391,11,2001,2012,61,-123.9135,44.7643,"phos"
"2664",10392,5,2001,2006,23,-123.852139,44.030139,"phos"
"2665",10393,11,2001,2012,62,-124.136694,43.078528,"phos"
"2666",10398,0,2003,2003,1,-116.999361,43.866639,"phos"
"2667",10401,1,2005,2006,4,-119.146514,44.415989,"phos"
"2668",10404,11,2001,2012,75,-119.035389,45.677444,"phos"
"2669",10405,0,2005,2005,2,-118.875611,45.65775,"phos"
"2670",10406,11,2001,2012,66,-118.7585,45.674806,"phos"
"2671",10407,11,2001,2012,63,-116.972222,44.05675,"phos"
"2672",10408,0,2006,2006,4,-117.141361,44.000222,"phos"
"2673",10410,11,2001,2012,58,-117.719639,45.621306,"phos"
"2674",10411,11,2001,2012,69,-120.910167,45.630222,"phos"
"2675",10413,2,2006,2008,3,-124.327472,42.481639,"phos"
"2676",10414,11,2001,2012,92,-124.292167,42.503667,"phos"
"2677",10418,11,2001,2012,67,-123.487278,42.496833,"phos"
"2678",10421,11,2001,2012,73,-123.089389,42.432694,"phos"
"2679",10423,11,2001,2012,86,-122.841583,42.525333,"phos"
"2680",10425,5,2002,2007,10,-124.063489,42.548747,"phos"
"2681",10428,11,2001,2012,55,-123.455833,42.3975,"phos"
"2682",10433,0,2005,2005,1,-122.818333,42.280278,"phos"
"2683",10437,11,2001,2012,60,-123.565833,43.631861,"phos"
"2684",10441,11,2001,2012,65,-123.563444,43.635139,"phos"
"2685",10442,11,2001,2012,62,-123.411056,43.241778,"phos"
"2686",10443,11,2001,2012,64,-123.397944,43.133889,"phos"
"2687",10451,11,2001,2012,49,-123.409222,43.271861,"phos"
"2688",10456,11,2001,2012,65,-122.756278,45.386139,"phos"
"2689",10458,11,2001,2012,63,-122.893667,45.409389,"phos"
"2690",10459,11,2001,2012,63,-122.919778,45.444415,"phos"
"2691",10461,11,2001,2012,63,-122.950556,45.490056,"phos"
"2692",10466,0,2008,2008,1,-123.124056,45.477639,"phos"
"2693",10469,11,2001,2012,75,-122.752778,45.415472,"phos"
"2694",10480,11,2001,2012,59,-122.89875,45.520861,"phos"
"2695",10506,11,2001,2012,58,-121.227806,44.761167,"phos"
"2696",10508,11,2001,2012,67,-121.293778,44.359917,"phos"
"2697",10509,1,2001,2002,7,-121.253861,44.268139,"phos"
"2698",10511,11,2001,2012,59,-121.320444,44.060083,"phos"
"2699",10517,11,2001,2012,65,-121.080694,44.348694,"phos"
"2700",10521,11,2001,2012,55,-123.9251,45.952,"phos"
"2701",10523,11,2001,2012,78,-123.8902,45.2071,"phos"
"2702",10533,11,2001,2012,78,-124.481417,42.81675,"phos"
"2703",10535,1,2008,2009,8,-124.352306,42.277056,"phos"
"2704",10537,11,2001,2012,87,-124.186139,42.007139,"phos"
"2705",10555,11,2001,2012,115,-123.041528,44.946111,"phos"
"2706",10573,0,2002,2002,2,-121.838333,42.158889,"phos"
"2707",10578,2,2005,2007,3,-123.764444,46.209722,"phos"
"2708",10579,6,2005,2011,5,-122.642583,45.440333,"phos"
"2709",10585,0,2008,2008,3,-123.751139,44.376111,"phos"
"2710",10588,0,2008,2008,2,-123.875583,44.534556,"phos"
"2711",10596,11,2001,2012,76,-124.192528,43.173778,"phos"
"2712",10599,6,2002,2008,12,-124.061667,42.58725,"phos"
"2713",10602,11,2001,2012,58,-122.855028,42.455444,"phos"
"2714",10611,11,2001,2012,107,-122.669889,45.513306,"phos"
"2715",10616,11,2001,2012,59,-122.738861,45.645639,"phos"
"2716",10637,11,2001,2012,61,-122.709222,45.267667,"phos"
"2717",10638,0,2008,2008,1,-122.537028,45.162694,"phos"
"2718",10640,11,2001,2012,62,-122.792528,45.150361,"phos"
"2719",10646,0,2005,2005,3,-122.824194,45.006583,"phos"
"2720",10662,11,2001,2012,89,-122.831222,44.055278,"phos"
"2721",10663,11,2001,2012,28,-122.959333,44.092306,"phos"
"2722",10674,11,2001,2012,59,-122.375444,45.5385,"phos"
"2723",10684,1,2001,2002,4,-121.410667,43.930806,"phos"
"2724",10686,11,2001,2012,63,-121.451194,43.863361,"phos"
"2725",10687,1,2001,2002,4,-121.4981,43.8174,"phos"
"2726",10688,11,2001,2012,61,-121.607028,43.743417,"phos"
"2727",10689,1,2001,2002,4,-121.688722,43.684417,"phos"
"2728",10690,11,2001,2012,69,-121.619528,44.5565,"phos"
"2729",10694,1,2001,2002,4,-121.463333,43.873028,"phos"
"2730",10696,11,2001,2012,54,-121.4513,43.8204,"phos"
"2731",10697,1,2001,2002,4,-121.500167,43.692306,"phos"
"2732",10698,1,2001,2002,4,-121.572028,43.661806,"phos"
"2733",10699,1,2001,2002,4,-121.6516,43.5248,"phos"
"2734",10703,1,2001,2002,4,-121.696889,43.463472,"phos"
"2735",10705,1,2001,2002,6,-121.5315,43.7943,"phos"
"2736",10719,11,2001,2012,57,-117.909278,45.566889,"phos"
"2737",10720,11,2001,2012,62,-118.235556,45.342111,"phos"
"2738",10724,11,2001,2012,56,-117.4675,44.818333,"phos"
"2739",10727,0,2006,2006,3,-117.363972,43.939472,"phos"
"2740",10728,11,2001,2012,65,-117.229167,43.988056,"phos"
"2741",10729,11,2001,2012,62,-117.054333,43.783861,"phos"
"2742",10730,4,2008,2012,5,-117.622806,42.840694,"phos"
"2743",10741,11,2001,2012,8,-119.901056,42.407139,"phos"
"2744",10743,2,2001,2003,6,-120.545028,42.696083,"phos"
"2745",10751,7,2001,2008,5,-120.389389,42.19325,"phos"
"2746",10758,0,2003,2003,5,-121.560417,42.010278,"phos"
"2747",10759,11,2001,2012,61,-121.622667,42.040417,"phos"
"2748",10762,0,2003,2003,3,-121.757694,42.154,"phos"
"2749",10763,11,2001,2012,69,-121.840722,42.079917,"phos"
"2750",10764,11,2001,2012,54,-122.059917,42.086917,"phos"
"2751",10765,11,2001,2012,69,-121.927778,42.128056,"phos"
"2752",10767,0,2002,2002,7,-121.797722,42.174944,"phos"
"2753",10768,11,2001,2012,71,-121.788361,42.218778,"phos"
"2754",10770,11,2001,2012,55,-121.916194,42.514611,"phos"
"2755",10792,11,2001,2012,62,-122.971111,44.708722,"phos"
"2756",10801,11,2001,2012,73,-122.709083,45.563806,"phos"
"2757",10811,0,2003,2003,3,-123.915833,46.168583,"phos"
"2758",10812,11,2001,2012,67,-123.924361,46.148972,"phos"
"2759",10813,0,2003,2003,1,-123.9089,46.0944,"phos"
"2760",10817,11,2001,2012,67,-123.839972,46.075028,"phos"
"2761",10853,0,2001,2001,2,-122.568333,45.467778,"phos"
"2762",10887,0,2005,2005,1,-122.785278,45.205667,"phos"
"2763",10896,1,2005,2006,6,-122.7804,45.1477,"phos"
"2764",10899,1,2005,2006,8,-122.8225,45.1004,"phos"
"2765",10917,11,2001,2012,70,-122.748972,45.233806,"phos"
"2766",10929,11,2001,2012,98,-123.17417,45.25194,"phos"
"2767",10948,11,2001,2012,68,-123.206917,45.168667,"phos"
"2768",10949,0,2009,2009,1,-123.263222,45.107917,"phos"
"2769",10957,0,2008,2008,4,-123.211806,45.116167,"phos"
"2770",10996,11,2001,2012,83,-123.459528,43.366361,"phos"
"2771",10997,11,2001,2012,63,-123.33575,42.943861,"phos"
"2772",11003,0,2005,2005,1,-123.86088,45.229944,"phos"
"2773",11017,11,2001,2012,61,-119.637694,44.756,"phos"
"2774",11020,11,2001,2012,63,-119.531222,44.465639,"phos"
"2775",11043,11,2001,2012,59,-117.268861,43.967306,"phos"
"2776",11044,0,2006,2006,3,-117.603722,43.854389,"phos"
"2777",11047,9,2003,2012,8,-118.331778,43.783778,"phos"
"2778",11050,1,2011,2012,4,-117.518556,42.904917,"phos"
"2779",11051,11,2001,2012,118,-122.937722,42.404722,"phos"
"2780",11123,3,2002,2005,36,-122.937306,42.403972,"phos"
"2781",11125,1,2007,2008,22,-122.924778,42.3895,"phos"
"2782",11128,6,2002,2008,84,-122.844667,42.314667,"phos"
"2783",11130,6,2002,2008,88,-122.779056,42.245556,"phos"
"2784",11133,6,2002,2008,86,-122.652139,42.185472,"phos"
"2785",11137,2,2001,2003,21,-123.285528,44.248333,"phos"
"2786",11138,2,2001,2003,21,-123.291417,44.216056,"phos"
"2787",11140,11,2001,2012,86,-123.294444,44.342861,"phos"
"2788",11178,0,2002,2002,4,-121.777333,42.216833,"phos"
"2789",11180,11,2001,2012,64,-123.127472,44.620222,"phos"
"2790",11182,1,2011,2012,5,-123.107472,44.504611,"phos"
"2791",11201,11,2001,2012,78,-122.753056,45.6105,"phos"
"2792",11233,11,2001,2012,56,-122.583139,45.378722,"phos"
"2793",11241,11,2001,2012,63,-123.944972,45.023417,"phos"
"2794",11263,11,2001,2012,64,-123.831,44.382694,"phos"
"2795",11275,11,2001,2012,70,-122.985111,44.010028,"phos"
"2796",11304,3,2001,2004,5,-123.337306,43.658306,"phos"
"2797",11305,3,2001,2004,4,-123.316139,43.660361,"phos"
"2798",11306,4,2001,2005,4,-123.279333,43.604222,"phos"
"2799",11310,2,2002,2004,6,-123.341361,43.2135,"phos"
"2800",11316,0,2004,2004,1,-123.294944,43.022944,"phos"
"2801",11321,11,2001,2012,67,-122.64225,45.447167,"phos"
"2802",11323,0,2001,2001,2,-122.616111,45.461667,"phos"
"2803",11326,0,2001,2001,3,-122.467778,45.486111,"phos"
"2804",11386,11,2001,2012,62,-120.468639,45.476861,"phos"
"2805",11434,11,2001,2012,69,-123.197583,46.102028,"phos"
"2806",11457,11,2001,2012,50,-117.729944,45.619556,"phos"
"2807",11476,11,2001,2012,71,-123.834778,44.657667,"phos"
"2808",11477,11,2001,2012,70,-120.541139,44.172556,"phos"
"2809",11478,11,2001,2012,88,-120.002694,44.792417,"phos"
"2810",11479,11,2001,2012,64,-119.470494,44.466331,"phos"
"2811",11480,11,2001,2012,67,-117.507583,43.910333,"phos"
"2812",11482,11,2001,2012,59,-123.68675,42.238389,"phos"
"2813",11483,11,2001,2012,63,-124.185889,42.123722,"phos"
"2814",11484,11,2001,2012,80,-123.21575,42.970944,"phos"
"2815",11485,11,2001,2012,62,-124.113167,43.032944,"phos"
"2816",11486,11,2001,2012,83,-124.149333,43.008528,"phos"
"2817",11489,11,2001,2012,60,-119.331944,45.835694,"phos"
"2818",11490,11,2001,2012,88,-117.826667,44.781944,"phos"
"2819",11491,6,2006,2012,50,-123.861972,43.788778,"phos"
"2820",11493,11,2001,2012,97,-124.395556,42.272222,"phos"
"2821",11494,11,2001,2012,60,-117.251947,44.356872,"phos"
"2822",11505,2,2006,2008,27,-123.199583,45.152722,"phos"
"2823",11514,0,2005,2005,3,-122.783333,45.095333,"phos"
"2824",11515,0,2005,2005,3,-122.787222,45.088222,"phos"
"2825",11521,11,2001,2012,53,-117.962611,45.349722,"phos"
"2826",11522,11,2001,2012,70,-123.365556,43.217778,"phos"
"2827",11523,6,2002,2008,49,-122.709861,42.215139,"phos"
"2828",11527,0,2005,2005,1,-123.178333,45.214444,"phos"
"2829",11539,0,2003,2003,1,-123.116111,44.094722,"phos"
"2830",11543,0,2005,2005,1,-118.838861,45.668556,"phos"
"2831",11544,4,2006,2010,4,-122.700028,45.614333,"phos"
"2832",11545,4,2002,2006,5,-123.395722,43.211056,"phos"
"2833",11550,0,2003,2003,1,-123.837333,45.485667,"phos"
"2834",11551,10,2001,2011,9,-122.759444,45.404167,"phos"
"2835",11555,9,2002,2011,7,-122.656667,45.417778,"phos"
"2836",11556,1,2002,2003,3,-123.201111,42.41875,"phos"
"2837",11558,0,2002,2002,2,-121.769222,42.197278,"phos"
"2838",11571,0,2006,2006,1,-124.105972,43.071667,"phos"
"2839",11586,0,2008,2008,2,-117.231772,45.397994,"phos"
"2840",11587,0,2008,2008,1,-117.232644,45.398289,"phos"
"2841",11598,0,2003,2003,7,-121.790667,42.178444,"phos"
"2842",11600,0,2002,2002,5,-121.781694,42.192389,"phos"
"2843",11626,8,2001,2009,13,-122.402278,45.473056,"phos"
"2844",11655,0,2002,2002,1,-122.529528,43.011083,"phos"
"2845",11656,0,2002,2002,1,-122.520361,43.010361,"phos"
"2846",11698,0,2007,2007,5,-124.189139,43.124528,"phos"
"2847",11704,0,2007,2007,5,-124.222139,43.177139,"phos"
"2848",11724,0,2007,2007,2,-124.146611,43.06975,"phos"
"2849",11725,2,2007,2009,5,-124.193667,43.173583,"phos"
"2850",11778,1,2005,2006,7,-120.793333,44.109722,"phos"
"2851",11783,0,2010,2010,1,-123.186583,45.855056,"phos"
"2852",11788,0,2009,2009,1,-123.18475,45.855639,"phos"
"2853",11824,3,2001,2004,3,-122.802694,45.008694,"phos"
"2854",11826,0,2009,2009,1,-120.599778,45.702889,"phos"
"2855",11850,0,2007,2007,1,-124.105722,44.186639,"phos"
"2856",11856,11,2001,2012,63,-123.842444,45.700361,"phos"
"2857",11857,2,2010,2012,15,-117.171833,44.74625,"phos"
"2858",11884,1,2006,2007,26,-124.208111,43.356306,"phos"
"2859",11904,11,2001,2012,73,-123.751111,46.091167,"phos"
"2860",11905,11,2001,2012,78,-124.487889,42.794389,"phos"
"2861",11940,9,2002,2011,7,-122.7695,45.294167,"phos"
"2862",11943,0,2006,2006,1,-122.759889,45.293111,"phos"
"2863",11968,0,2005,2005,4,-121.543222,45.626444,"phos"
"2864",11969,0,2005,2005,1,-121.543889,45.627972,"phos"
"2865",11971,0,2005,2005,4,-121.512917,45.644222,"phos"
"2866",11972,0,2005,2005,3,-121.51517,45.64377,"phos"
"2867",11973,0,2005,2005,2,-121.52925,45.627583,"phos"
"2868",11974,0,2005,2005,2,-121.527333,45.627722,"phos"
"2869",12005,11,2001,2012,77,-118.823028,45.654444,"phos"
"2870",12012,11,2001,2012,61,-121.506722,45.710722,"phos"
"2871",12026,1,2011,2012,3,-119.198083,45.74225,"phos"
"2872",12053,0,2001,2001,1,-118.4025,45.2624,"phos"
"2873",12054,0,2001,2001,1,-118.4043,45.2627,"phos"
"2874",12055,4,2001,2005,6,-118.4287,45.2697,"phos"
"2875",12057,4,2001,2005,6,-118.4017,45.2608,"phos"
"2876",12058,2,2001,2003,6,-118.5295,45.2699,"phos"
"2877",12059,2,2001,2003,5,-118.3828,45.275,"phos"
"2878",12091,0,2007,2007,1,-123.982389,42.044306,"phos"
"2879",12095,0,2007,2007,2,-124.089861,42.048972,"phos"
"2880",12099,0,2002,2002,4,-124.231306,42.488083,"phos"
"2881",12134,0,2007,2007,1,-123.944167,43.69,"phos"
"2882",12181,2,2001,2003,6,-118.533,45.0912,"phos"
"2883",12182,2,2001,2003,5,-118.2985,45.107472,"phos"
"2884",12183,4,2001,2005,10,-118.3307,45.102556,"phos"
"2885",12187,11,2001,2012,62,-123.785583,46.069556,"phos"
"2886",12189,0,2005,2005,1,-118.833306,45.671639,"phos"
"2887",12212,0,2005,2005,6,-120.716583,44.299083,"phos"
"2888",12215,5,2002,2007,2,-123.253833,45.567306,"phos"
"2889",12245,2,2002,2004,3,-123.298333,43.016944,"phos"
"2890",12248,0,2004,2004,1,-123.4275,43.117778,"phos"
"2891",12251,2,2002,2004,2,-123.385556,43.080861,"phos"
"2892",12257,2,2001,2003,3,-119.088583,43.652417,"phos"
"2893",12258,7,2001,2008,5,-117.729878,43.007536,"phos"
"2894",12260,5,2001,2006,4,-117.609444,42.805056,"phos"
"2895",12261,11,2001,2012,9,-116.995278,42.911389,"phos"
"2896",12262,7,2001,2008,5,-117.180944,42.52625,"phos"
"2897",12263,7,2001,2008,5,-117.156389,42.543944,"phos"
"2898",12264,11,2001,2012,7,-118.234111,42.337611,"phos"
"2899",12265,11,2001,2012,10,-118.866583,42.801083,"phos"
"2900",12266,11,2001,2012,11,-119.841944,42.176111,"phos"
"2901",12267,11,2001,2012,9,-119.926667,42.174444,"phos"
"2902",12269,5,2001,2006,4,-118.369333,42.187167,"phos"
"2903",12278,0,2007,2007,1,-123.588278,45.494944,"phos"
"2904",12301,0,2008,2008,9,-123.774778,44.635222,"phos"
"2905",12308,6,2002,2008,79,-122.715722,42.214417,"phos"
"2906",12346,0,2003,2003,1,-121.908139,44.431722,"phos"
"2907",12351,0,2003,2003,1,-123.939889,45.609722,"phos"
"2908",12376,6,2002,2008,52,-122.787167,42.253778,"phos"
"2909",12377,6,2002,2008,58,-122.870667,42.332722,"phos"
"2910",12488,0,2001,2001,3,-121.94731,42.133347,"phos"
"2911",12490,0,2003,2003,4,-121.7775,41.996667,"phos"
"2912",12509,0,2007,2007,1,-123.439444,44.138889,"phos"
"2913",12521,0,2007,2007,1,-123.971083,43.963306,"phos"
"2914",12534,6,2002,2008,89,-122.738722,42.222722,"phos"
"2915",12535,6,2002,2008,88,-122.810056,42.279139,"phos"
"2916",12536,6,2002,2008,88,-122.884278,42.36525,"phos"
"2917",12537,6,2002,2008,85,-122.924472,42.394417,"phos"
"2918",12552,11,2001,2012,61,-122.161389,44.174167,"phos"
"2919",12553,11,2001,2012,60,-122.411667,44.752778,"phos"
"2920",12559,11,2001,2012,75,-122.048611,44.693222,"phos"
"2921",12560,1,2001,2002,5,-121.52883,43.77214,"phos"
"2922",12561,1,2001,2002,4,-121.305833,44.079167,"phos"
"2923",12564,0,2001,2001,1,-121.840194,43.496778,"phos"
"2924",12565,1,2001,2002,4,-121.677389,43.520778,"phos"
"2925",12566,1,2001,2002,2,-121.333833,44.461306,"phos"
"2926",12567,1,2001,2002,4,-121.4761,43.7705,"phos"
"2927",12573,0,2002,2002,1,-123.279889,42.942556,"phos"
"2928",12578,0,2002,2002,1,-123.891028,45.206028,"phos"
"2929",12587,3,2002,2005,40,-122.955806,42.426389,"phos"
"2930",12590,11,2001,2012,95,-124.451694,42.916278,"phos"
"2931",12604,0,2009,2009,1,-124.179806,43.57175,"phos"
"2932",12605,0,2009,2009,1,-124.180111,43.571306,"phos"
"2933",12617,9,2002,2011,5,-117.828528,44.817083,"phos"
"2934",12624,1,2011,2012,3,-117.883944,45.01375,"phos"
"2935",12627,1,2011,2012,4,-117.900778,45.034722,"phos"
"2936",12655,4,2001,2005,22,-122.339778,44.155444,"phos"
"2937",12656,4,2001,2005,24,-122.259139,44.157333,"phos"
"2938",12657,4,2001,2005,19,-121.995611,44.35625,"phos"
"2939",12692,0,2003,2003,12,-123.929167,46.100278,"phos"
"2940",12719,1,2007,2008,22,-122.927056,42.362583,"phos"
"2941",12728,1,2007,2008,21,-122.919611,42.362694,"phos"
"2942",12796,4,2002,2006,6,-123.240833,43.443306,"phos"
"2943",12800,4,2002,2006,6,-123.3075,43.421111,"phos"
"2944",12803,4,2002,2006,8,-123.163861,43.409,"phos"
"2945",12807,0,2002,2002,3,-123.324417,43.416333,"phos"
"2946",12832,0,2007,2007,2,-123.857111,45.501278,"phos"
"2947",12841,9,2002,2011,5,-123.855361,45.456944,"phos"
"2948",12900,0,2004,2004,1,-123.395278,43.2115,"phos"
"2949",12911,7,2002,2009,2,-123.355083,42.949972,"phos"
"2950",12913,0,2002,2002,1,-123.3565,42.949556,"phos"
"2951",12974,0,2009,2009,1,-123.205556,46.107222,"phos"
"2952",12975,0,2009,2009,1,-123.207222,46.107222,"phos"
"2953",12978,0,2009,2009,1,-122.943056,46.091667,"phos"
"2954",12982,0,2002,2002,1,-123.9653,45.2103,"phos"
"2955",12987,6,2005,2011,2,-123.8,46.143333,"phos"
"2956",12997,4,2001,2005,6,-118.4174,45.2665,"phos"
"2957",13014,11,2001,2012,9,-118.763167,42.63875,"phos"
"2958",13039,0,2007,2007,2,-123.841806,45.468194,"phos"
"2959",13049,4,2002,2006,2,-123.430639,42.741167,"phos"
"2960",13050,0,2002,2002,1,-123.430611,42.738944,"phos"
"2961",13055,0,2006,2006,1,-116.998333,43.902222,"phos"
"2962",13056,0,2006,2006,3,-116.982778,43.875278,"phos"
"2963",13057,0,2006,2006,3,-116.988056,43.875833,"phos"
"2964",13064,0,2006,2006,1,-117.248056,44.354722,"phos"
"2965",13065,0,2006,2006,1,-117.250028,44.357167,"phos"
"2966",13066,0,2006,2006,1,-117.251917,44.357056,"phos"
"2967",13067,0,2006,2006,1,-117.255667,44.356417,"phos"
"2968",13070,11,2001,2012,104,-122.360361,45.299389,"phos"
"2969",13073,0,2006,2006,1,-122.571806,42.546806,"phos"
"2970",13074,0,2006,2006,1,-122.567306,42.547694,"phos"
"2971",13075,0,2006,2006,1,-122.568944,42.547778,"phos"
"2972",13141,0,2005,2005,1,-121.524611,45.663722,"phos"
"2973",13171,0,2005,2005,2,-121.522028,45.62875,"phos"
"2974",13172,0,2005,2005,2,-121.543694,45.623917,"phos"
"2975",13173,0,2005,2005,4,-121.544222,45.631361,"phos"
"2976",13195,3,2002,2005,3,-123.5225,45.245861,"phos"
"2977",13196,0,2005,2005,1,-123.483222,42.523528,"phos"
"2978",13216,0,2009,2009,3,-124.007806,43.490444,"phos"
"2979",13223,0,2007,2007,2,-123.742306,45.595028,"phos"
"2980",13229,0,2007,2007,2,-124.156639,42.437861,"phos"
"2981",13263,0,2005,2005,1,-123.971944,44.216139,"phos"
"2982",13368,0,2012,2012,2,-123.771417,45.722333,"phos"
"2983",13386,0,2006,2006,4,-124.208889,43.364167,"phos"
"2984",13388,1,2006,2007,27,-124.192778,43.356667,"phos"
"2985",13389,1,2006,2007,28,-124.206944,43.301389,"phos"
"2986",13411,11,2001,2012,69,-123.872306,45.575167,"phos"
"2987",13417,11,2001,2012,67,-123.842583,45.496306,"phos"
"2988",13421,11,2001,2012,59,-123.843111,45.478028,"phos"
"2989",13424,11,2001,2012,59,-123.735611,45.471806,"phos"
"2990",13428,5,2007,2012,46,-123.843889,45.465278,"phos"
"2991",13429,5,2007,2012,36,-123.809167,45.470833,"phos"
"2992",13430,5,2007,2012,50,-123.844444,45.459167,"phos"
"2993",13431,5,2007,2012,37,-123.85853,45.456389,"phos"
"2994",13433,11,2001,2012,59,-123.822778,45.429861,"phos"
"2995",13440,11,2001,2012,66,-123.824722,45.408611,"phos"
"2996",13540,0,2006,2006,7,-124.192222,43.335556,"phos"
"2997",13568,0,2009,2009,3,-124.023333,43.433056,"phos"
"2998",13569,0,2009,2009,3,-124.030556,43.425,"phos"
"2999",13570,11,2001,2012,77,-124.058583,43.405667,"phos"
"3000",13574,11,2001,2012,63,-124.083083,43.363861,"phos"
"3001",13583,1,2006,2007,17,-124.204083,43.325778,"phos"
"3002",13632,0,2002,2002,1,-123.955556,45.890278,"phos"
"3003",13781,0,2002,2002,19,-122.346389,42.378056,"phos"
"3004",13782,1,2004,2005,11,-124.505139,42.896361,"phos"
"3005",13787,0,2003,2003,6,-124.506778,42.75425,"phos"
"3006",13807,1,2003,2004,6,-121.774294,43.925019,"phos"
"3007",13945,0,2002,2002,22,-122.154333,43.170278,"phos"
"3008",13959,0,2003,2003,10,-123.903056,46.084167,"phos"
"3009",14008,11,2001,2012,64,-122.150861,45.162722,"phos"
"3010",14018,6,2004,2010,67,-124.118972,43.548111,"phos"
"3011",14185,0,2002,2002,1,-124.0593,44.6967,"phos"
"3012",14247,0,2005,2005,1,-124.356111,43.2025,"phos"
"3013",14248,5,2005,2010,2,-124.350833,43.208889,"phos"
"3014",14268,0,2009,2009,1,-124.316389,43.210278,"phos"
"3015",14434,0,2009,2009,1,-123.244444,44.697778,"phos"
"3016",14435,0,2006,2006,2,-123.246111,44.699444,"phos"
"3017",14509,0,2002,2002,2,-120.287417,45.603194,"phos"
"3018",14510,0,2002,2002,1,-120.295528,45.574944,"phos"
"3019",14734,0,2003,2003,1,-122.774444,42.376111,"phos"
"3020",14741,6,2003,2009,2,-122.770833,42.385556,"phos"
"3021",14776,0,2003,2003,1,-122.447361,45.55875,"phos"
"3022",15009,0,2009,2009,1,-124.292222,43.316667,"phos"
"3023",15020,0,2006,2006,1,-124.291111,43.316667,"phos"
"3024",15119,0,2008,2008,1,-122.8725,45.409722,"phos"
"3025",15120,2,2008,2010,2,-122.871944,45.407222,"phos"
"3026",15121,2,2008,2010,2,-122.870833,45.408889,"phos"
"3027",15122,2,2008,2010,2,-122.870278,45.408333,"phos"
"3028",15123,2,2008,2010,2,-122.872778,45.408333,"phos"
"3029",15124,2,2008,2010,2,-122.872778,45.408611,"phos"
"3030",15125,2,2008,2010,3,-122.869167,45.408333,"phos"
"3031",15126,2,2008,2010,3,-122.870833,45.408333,"phos"
"3032",15144,9,2002,2011,10,-117.229167,43.988056,"phos"
"3033",15151,9,2002,2011,14,-117.035,44.011,"phos"
"3034",15155,9,2002,2011,8,-116.955,44.02,"phos"
"3035",15169,8,2002,2010,8,-117.01,44.026,"phos"
"3036",15174,8,2002,2010,10,-117.023,44.013,"phos"
"3037",15180,9,2002,2011,10,-117.011,43.988,"phos"
"3038",15183,9,2002,2011,10,-116.99,43.962,"phos"
"3039",15186,9,2002,2011,11,-117.023,43.997,"phos"
"3040",15201,8,2002,2010,8,-116.995,44.199,"phos"
"3041",15203,9,2002,2011,10,-116.963,44.096,"phos"
"3042",15216,9,2002,2011,9,-116.985,43.895,"phos"
"3043",15217,9,2002,2011,11,-116.994,43.923,"phos"
"3044",15221,9,2002,2011,10,-116.993,43.953,"phos"
"3045",15229,9,2002,2011,10,-117.078,44.01,"phos"
"3046",15233,9,2002,2011,9,-117.268861,43.967306,"phos"
"3047",15234,9,2002,2011,9,-117.018,44.019,"phos"
"3048",15236,9,2002,2011,15,-117.004,43.931,"phos"
"3049",15244,9,2002,2011,11,-117.260194,44.026639,"phos"
"3050",15249,9,2002,2011,11,-117.08,43.997,"phos"
"3051",15253,9,2002,2011,11,-117.185,44.003,"phos"
"3052",15254,9,2002,2011,10,-117.237,43.986,"phos"
"3053",15257,9,2002,2011,12,-117.228,43.994,"phos"
"3054",15264,9,2002,2011,12,-117.049944,43.995833,"phos"
"3055",15275,8,2002,2010,8,-116.99,44.062,"phos"
"3056",15280,7,2002,2009,9,-116.989,44.061,"phos"
"3057",15284,9,2002,2011,12,-117.2925,43.909722,"phos"
"3058",15289,9,2002,2011,10,-116.995,44.198333,"phos"
"3059",15291,9,2002,2011,14,-117.175,44.136111,"phos"
"3060",15294,9,2002,2011,10,-117.248333,43.966667,"phos"
"3061",15302,9,2002,2011,9,-117.061111,43.992222,"phos"
"3062",15327,9,2002,2011,9,-117.035278,44.010833,"phos"
"3063",15328,8,2003,2011,11,-117.004167,44.230556,"phos"
"3064",15329,9,2002,2011,11,-117.004194,43.894444,"phos"
"3065",15517,9,2002,2011,10,-117.155,43.796,"phos"
"3066",15525,6,2002,2008,2,-117.055944,43.796,"phos"
"3067",15538,9,2002,2011,12,-117.24425,43.643056,"phos"
"3068",15540,9,2002,2011,10,-117.111111,43.780556,"phos"
"3069",15541,9,2002,2011,10,-117.145833,43.786111,"phos"
"3070",15697,0,2006,2006,1,-123.3772,43.1847,"phos"
"3071",15700,0,2006,2006,1,-123.3876,43.1851,"phos"
"3072",15721,0,2006,2006,1,-123.365278,43.187222,"phos"
"3073",15785,3,2006,2009,2,-123.012222,43.954444,"phos"
"3074",15869,0,2009,2009,1,-122.953889,42.304444,"phos"
"3075",15913,0,2011,2011,1,-122.759167,45.620833,"phos"
"3076",15914,0,2011,2011,1,-122.757778,45.618056,"phos"
"3077",15916,0,2011,2011,1,-122.761389,45.615833,"phos"
"3078",15917,0,2008,2008,2,-122.761389,45.615833,"phos"
"3079",15924,0,2011,2011,1,-122.745,45.613056,"phos"
"3080",15936,0,2008,2008,1,-122.752333,45.618806,"phos"
"3081",15938,0,2008,2008,1,-122.744167,45.615444,"phos"
"3082",15940,0,2011,2011,1,-122.753889,45.618889,"phos"
"3083",15947,3,2008,2011,2,-122.758611,45.618056,"phos"
"3084",15970,0,2005,2005,1,-123.837222,45.416111,"phos"
"3085",15971,0,2005,2005,1,-123.836111,45.417222,"phos"
"3086",15972,0,2005,2005,1,-123.84,45.408889,"phos"
"3087",15990,0,2005,2005,1,-123.847222,45.416389,"phos"
"3088",16018,5,2001,2006,13,-119.6881,45.8296,"phos"
"3089",16019,10,2001,2011,16,-119.7083,45.8194,"phos"
"3090",16023,10,2001,2011,24,-119.5315,45.8973,"phos"
"3091",16024,10,2001,2011,19,-119.5395,45.9023,"phos"
"3092",16026,0,2009,2009,1,-119.504389,45.894417,"phos"
"3093",16028,10,2001,2011,19,-119.3282,45.9196,"phos"
"3094",16029,1,2001,2002,4,-119.2732,45.8651,"phos"
"3095",16031,0,2009,2009,1,-119.237111,45.858139,"phos"
"3096",16036,8,2001,2009,19,-119.221,45.8344,"phos"
"3097",16037,10,2001,2011,19,-119.2252,45.7856,"phos"
"3098",16038,10,2001,2011,22,-119.2168,45.7865,"phos"
"3099",16046,10,2001,2011,21,-119.1537,45.8248,"phos"
"3100",16047,0,2009,2009,1,-119.244611,45.885361,"phos"
"3101",16048,3,2001,2004,9,-119.3098,45.7946,"phos"
"3102",16055,0,2009,2009,1,-119.163889,45.917778,"phos"
"3103",16056,1,2001,2002,3,-119.1711,45.9106,"phos"
"3104",16063,0,2009,2009,1,-119.3325,45.812778,"phos"
"3105",16069,0,2009,2009,1,-119.368889,45.783333,"phos"
"3106",16070,0,2009,2009,1,-119.328333,45.785556,"phos"
"3107",16072,0,2009,2009,1,-119.281111,45.824444,"phos"
"3108",16074,10,2001,2011,22,-119.3209,45.8132,"phos"
"3109",16075,6,2001,2007,14,-119.6429,45.8288,"phos"
"3110",16076,0,2009,2009,2,-119.690833,45.844444,"phos"
"3111",16078,1,2001,2002,4,NA,NA,"phos"
"3112",16079,0,2009,2009,1,-119.314167,45.819167,"phos"
"3113",16084,10,2001,2011,19,-119.353,45.8291,"phos"
"3114",16086,10,2001,2011,19,-119.3817,45.9132,"phos"
"3115",16093,10,2001,2011,21,-119.4396,45.9055,"phos"
"3116",16096,10,2001,2011,22,-119.1896,45.8637,"phos"
"3117",16099,10,2001,2011,22,-119.2194,45.8865,"phos"
"3118",16100,10,2001,2011,21,-119.1641,45.8467,"phos"
"3119",16102,10,2001,2011,19,-119.3884,45.7707,"phos"
"3120",16106,10,2001,2011,19,-119.2115,45.8647,"phos"
"3121",16109,10,2001,2011,22,-119.3151,45.8232,"phos"
"3122",16112,4,2001,2005,11,-119.3268,45.7903,"phos"
"3123",16113,0,2009,2009,1,-119.325556,45.784722,"phos"
"3124",16114,0,2009,2009,2,-119.262778,45.820278,"phos"
"3125",16122,0,2009,2009,1,-119.351944,45.843333,"phos"
"3126",16123,10,2001,2011,18,-119.4351,45.7736,"phos"
"3127",16126,0,2009,2009,1,-119.372778,45.821944,"phos"
"3128",16128,0,2009,2009,1,-119.351667,45.848889,"phos"
"3129",16134,10,2001,2011,18,-119.5065,45.8863,"phos"
"3130",16146,10,2001,2011,22,-119.2396,45.8358,"phos"
"3131",16150,10,2001,2011,19,-119.5597,45.8658,"phos"
"3132",16151,0,2009,2009,2,-119.553333,45.888889,"phos"
"3133",16153,0,2009,2009,1,-119.566944,45.918889,"phos"
"3134",16154,9,2002,2011,17,-119.5067,45.8988,"phos"
"3135",16158,10,2001,2011,19,-119.4756,45.8065,"phos"
"3136",16164,0,2009,2009,1,-119.589167,45.876389,"phos"
"3137",16167,0,2009,2009,1,-119.64,45.848889,"phos"
"3138",16170,10,2001,2011,20,-119.5102,45.8747,"phos"
"3139",16175,10,2001,2011,20,-119.343,45.7476,"phos"
"3140",16176,0,2009,2009,1,-119.396111,45.71,"phos"
"3141",16177,10,2001,2011,20,-119.3733,45.6978,"phos"
"3142",16180,10,2001,2011,21,-119.1966,45.7317,"phos"
"3143",16181,10,2001,2011,23,-119.2105,45.7586,"phos"
"3144",16182,0,2009,2009,1,-119.240556,45.747778,"phos"
"3145",16188,10,2001,2011,22,-119.3728,45.8463,"phos"
"3146",16191,10,2001,2011,20,-119.6539,45.8509,"phos"
"3147",16198,0,2009,2009,1,-119.398139,45.852972,"phos"
"3148",16208,0,2010,2010,1,-119.453083,45.851944,"phos"
"3149",16209,0,2009,2009,1,-119.389944,45.8495,"phos"
"3150",16212,0,2009,2009,1,-119.397056,45.846083,"phos"
"3151",16214,0,2010,2010,1,-119.428472,45.828583,"phos"
"3152",16215,0,2010,2010,1,-119.428639,45.828639,"phos"
"3153",16218,0,2010,2010,1,-119.438278,45.837306,"phos"
"3154",16221,0,2009,2009,1,-119.602278,45.858361,"phos"
"3155",16222,0,2009,2009,1,-119.620583,45.848278,"phos"
"3156",16223,0,2009,2009,1,-119.623583,45.807,"phos"
"3157",16224,0,2009,2009,1,-119.380472,45.858,"phos"
"3158",16226,0,2009,2009,1,-119.357778,45.858306,"phos"
"3159",16227,0,2009,2009,1,-119.359806,45.858278,"phos"
"3160",16228,0,2009,2009,1,-119.378694,45.857972,"phos"
"3161",16229,0,2009,2009,1,-119.383139,45.769639,"phos"
"3162",16230,0,2009,2009,1,-119.439139,45.748167,"phos"
"3163",16231,0,2009,2009,1,-119.407139,45.730306,"phos"
"3164",16232,0,2009,2009,1,-119.347833,45.740917,"phos"
"3165",16233,0,2009,2009,1,-119.358056,45.864083,"phos"
"3166",16234,0,2009,2009,1,-119.232611,45.780722,"phos"
"3167",16235,0,2009,2009,1,-119.315528,45.797139,"phos"
"3168",16236,0,2009,2009,1,-119.315167,45.792972,"phos"
"3169",16237,0,2010,2010,1,-119.315167,45.792972,"phos"
"3170",16238,0,2010,2010,1,-119.287139,45.791944,"phos"
"3171",16240,0,2009,2009,1,-119.301722,45.792611,"phos"
"3172",16241,0,2009,2009,1,-119.331167,45.768917,"phos"
"3173",16242,0,2010,2010,1,-119.32175,45.773611,"phos"
"3174",16243,0,2009,2009,1,-119.310139,45.762861,"phos"
"3175",16244,0,2009,2009,1,-119.363583,45.737278,"phos"
"3176",16245,0,2010,2010,1,-119.351444,45.759278,"phos"
"3177",16248,0,2010,2010,1,-119.293472,45.794167,"phos"
"3178",16249,0,2009,2009,1,-119.232583,45.781,"phos"
"3179",16250,0,2009,2009,1,-119.226333,45.782806,"phos"
"3180",16251,0,2009,2009,2,-119.315528,45.797167,"phos"
"3181",16252,0,2009,2009,1,-119.226583,45.782861,"phos"
"3182",16253,0,2009,2009,1,-119.225083,45.806333,"phos"
"3183",16254,0,2009,2009,2,-119.235694,45.82025,"phos"
"3184",16256,0,2010,2010,1,-119.473528,45.897889,"phos"
"3185",16257,0,2010,2010,1,-119.474639,45.898944,"phos"
"3186",16258,0,2010,2010,1,-119.475972,45.900028,"phos"
"3187",16261,0,2010,2010,1,-119.870833,45.704333,"phos"
"3188",16262,0,2010,2010,1,-119.819778,45.698944,"phos"
"3189",16263,0,2010,2010,2,-119.833306,45.720694,"phos"
"3190",16264,0,2010,2010,1,-119.866194,45.795611,"phos"
"3191",16278,0,2003,2003,1,-124.071,44.3998,"phos"
"3192",16537,0,2002,2002,1,-123.219444,44.25,"phos"
"3193",16545,0,2002,2002,1,-123.245,44.25249,"phos"
"3194",16553,0,2002,2002,1,-123.18777,44.207779,"phos"
"3195",16656,0,2002,2002,1,-123.0744,44.13537,"phos"
"3196",16658,0,2002,2002,1,-123.0946,44.13508,"phos"
"3197",16660,0,2002,2002,2,-123.0974,44.14236,"phos"
"3198",16732,0,2006,2006,1,-123.112778,44.098333,"phos"
"3199",16733,0,2006,2006,1,-123.106667,44.1075,"phos"
"3200",16734,3,2003,2006,2,-123.106111,44.107778,"phos"
"3201",16737,3,2003,2006,3,-123.108611,44.104167,"phos"
"3202",16738,3,2003,2006,3,-123.111111,44.100556,"phos"
"3203",16742,0,2007,2007,1,-123.3382,43.3371,"phos"
"3204",16743,0,2007,2007,1,-123.337778,43.335833,"phos"
"3205",16997,0,2005,2005,1,-120.860444,44.301972,"phos"
"3206",17164,0,2002,2002,1,-122.857361,42.963389,"phos"
"3207",18774,0,2001,2001,1,-124.105528,44.265667,"phos"
"3208",18775,0,2001,2001,1,-123.845472,44.319833,"phos"
"3209",18789,0,2002,2002,1,-123.611389,42.80375,"phos"
"3210",18796,0,2001,2001,1,-123.7928,44.7456,"phos"
"3211",18797,0,2001,2001,1,-123.9003,45.1404,"phos"
"3212",18802,0,2001,2001,1,-123.769111,45.813472,"phos"
"3213",18803,0,2001,2001,2,-123.765083,43.806222,"phos"
"3214",18804,0,2001,2001,1,-124.10825,44.224194,"phos"
"3215",18821,5,2003,2008,7,-124.427583,42.965917,"phos"
"3216",18822,5,2003,2008,10,-124.414333,43.003361,"phos"
"3217",18823,5,2003,2008,14,-124.41375,43.052083,"phos"
"3218",18824,3,2003,2006,6,-124.423417,42.975472,"phos"
"3219",20391,0,2005,2005,1,-124.067333,42.8885,"phos"
"3220",20392,0,2005,2005,1,-124.06725,42.88875,"phos"
"3221",20394,6,2005,2011,7,-124.067417,42.888111,"phos"
"3222",20447,7,2004,2011,15,-124.096472,43.595028,"phos"
"3223",21506,0,2002,2002,1,-122.551833,42.997944,"phos"
"3224",21535,1,2011,2012,6,-121.500333,42.462,"phos"
"3225",21790,0,2002,2002,2,-123.979761,44.499656,"phos"
"3226",21791,5,2002,2007,6,-124.105811,44.170708,"phos"
"3227",21792,0,2003,2003,2,-123.92875,44.580669,"phos"
"3228",21794,2,2003,2005,2,-124.305169,42.804089,"phos"
"3229",21797,2,2003,2005,2,-124.185911,42.974633,"phos"
"3230",21799,0,2002,2002,1,-124.029111,42.768633,"phos"
"3231",21800,0,2011,2011,7,-123.55045,45.277942,"phos"
"3232",21804,3,2002,2005,3,-123.621869,45.228936,"phos"
"3233",21805,3,2002,2005,3,-123.830931,45.351989,"phos"
"3234",21806,0,2002,2002,1,-123.822639,45.284822,"phos"
"3235",21807,0,2002,2002,1,-123.8835,45.912014,"phos"
"3236",21811,3,2002,2005,5,-123.51585,45.585806,"phos"
"3237",21812,0,2002,2002,1,-123.490039,45.552708,"phos"
"3238",21813,0,2002,2002,2,-123.284581,45.736719,"phos"
"3239",21822,3,2002,2005,5,-123.238861,42.101917,"phos"
"3240",21832,0,2002,2002,2,-122.251917,44.437386,"phos"
"3241",21833,0,2002,2002,1,-122.736606,44.258794,"phos"
"3242",21835,0,2001,2001,1,-122.101831,44.782844,"phos"
"3243",21839,3,2002,2005,5,-122.889283,43.740583,"phos"
"3244",21841,0,2002,2002,1,-123.125125,45.508128,"phos"
"3245",21842,1,2007,2008,3,-123.851073,44.538726,"phos"
"3246",21849,0,2007,2007,1,-124.034286,42.573014,"phos"
"3247",22369,0,2011,2011,3,-123.706519,45.277064,"phos"
"3248",22375,0,2011,2011,6,-123.603114,45.239361,"phos"
"3249",22383,0,2011,2011,7,-123.580667,45.265833,"phos"
"3250",22386,0,2008,2008,1,-123.168453,45.436233,"phos"
"3251",22394,0,2011,2011,6,-123.818167,45.2765,"phos"
"3252",22569,2,2001,2003,12,-121.464178,43.824022,"phos"
"3253",22571,0,2002,2002,1,-121.464156,43.824003,"phos"
"3254",22572,1,2001,2002,5,-121.464147,43.823897,"phos"
"3255",22573,1,2001,2002,4,-121.464156,43.823744,"phos"
"3256",22574,1,2001,2002,3,-121.464642,43.823903,"phos"
"3257",22651,0,2006,2006,1,-122.7605,44.254167,"phos"
"3258",22654,0,2006,2006,2,-122.854083,44.172861,"phos"
"3259",22679,0,2004,2004,1,-123.426304,43.099508,"phos"
"3260",22680,0,2004,2004,1,-123.426256,43.102881,"phos"
"3261",22715,0,2002,2002,1,-122.995,44.900278,"phos"
"3262",22716,0,2002,2002,2,-122.998056,44.901389,"phos"
"3263",22719,0,2002,2002,1,-122.993889,44.897222,"phos"
"3264",22721,6,2003,2009,2,-122.770278,42.386111,"phos"
"3265",22931,9,2002,2011,4,-123.366278,46.031611,"phos"
"3266",22965,0,2005,2005,2,-121.495472,45.651611,"phos"
"3267",22966,0,2005,2005,1,-121.495667,45.651639,"phos"
"3268",22970,0,2005,2005,2,-121.543528,45.635028,"phos"
"3269",22971,0,2005,2005,1,-121.534306,45.628639,"phos"
"3270",22972,0,2005,2005,2,-121.530056,45.627278,"phos"
"3271",22973,0,2005,2005,2,-121.529611,45.627278,"phos"
"3272",22974,0,2005,2005,2,-121.528,45.627278,"phos"
"3273",22978,0,2005,2005,2,-121.518778,45.638889,"phos"
"3274",22985,0,2005,2005,1,-118.84027,45.668152,"phos"
"3275",22986,0,2005,2005,1,-118.84195,45.66786,"phos"
"3276",23038,0,2005,2005,1,-118.83934,45.66825,"phos"
"3277",23176,1,2003,2004,2,-122.86,45.181667,"phos"
"3278",23195,9,2002,2011,10,-116.995,44.198333,"phos"
"3279",23196,0,2008,2008,1,-118.116667,45.3525,"phos"
"3280",23197,0,2008,2008,1,-118.121667,45.348333,"phos"
"3281",23198,0,2008,2008,2,-118.121944,45.347778,"phos"
"3282",23402,0,2002,2002,1,-123.999406,42.454753,"phos"
"3283",23408,0,2002,2002,1,-124.037414,42.514094,"phos"
"3284",23509,0,2012,2012,2,-123.589979,45.84384,"phos"
"3285",23737,9,2002,2011,10,-116.99405,44.242883,"phos"
"3286",23753,6,2003,2009,21,-124.407222,42.371944,"phos"
"3287",23761,5,2003,2008,6,-124.494653,42.764017,"phos"
"3288",23797,2,2001,2003,13,-122.826317,45.970117,"phos"
"3289",23800,2,2001,2003,14,-123.4242,46.220683,"phos"
"3290",23815,0,2003,2003,1,-123.846842,45.897376,"phos"
"3291",23816,0,2003,2003,1,-123.754676,45.545668,"phos"
"3292",23819,0,2003,2003,1,-123.488,45.4743,"phos"
"3293",23821,0,2003,2003,1,-123.68697,44.197048,"phos"
"3294",23823,0,2003,2003,1,-123.9838,44.085856,"phos"
"3295",23836,3,2002,2005,4,-123.39559,42.781741,"phos"
"3296",23837,3,2002,2005,4,-123.60948,43.45645,"phos"
"3297",23839,0,2003,2003,1,-123.20991,42.602606,"phos"
"3298",23840,0,2007,2007,2,-123.5701,42.655431,"phos"
"3299",23843,0,2007,2007,1,-123.23909,42.07499,"phos"
"3300",23847,4,2001,2005,4,-122.3852,44.427415,"phos"
"3301",23851,0,2001,2001,2,-121.999052,44.57005,"phos"
"3302",23853,0,2003,2003,1,-123.350797,45.173487,"phos"
"3303",23854,0,2003,2003,1,-123.55147,45.000534,"phos"
"3304",23857,0,2003,2003,1,-122.677977,43.620848,"phos"
"3305",23859,2,2001,2003,21,-123.393163,44.265533,"phos"
"3306",23863,0,2007,2007,2,-123.311606,44.415841,"phos"
"3307",23892,2,2005,2007,22,-122.99812,43.32422,"phos"
"3308",23897,2,2005,2007,21,-122.54524,43.29207,"phos"
"3309",23930,0,2006,2006,4,-124.498122,42.91153,"phos"
"3310",23931,0,2006,2006,3,-124.49281,42.91442,"phos"
"3311",24037,0,2003,2003,2,-123.918611,46.128611,"phos"
"3312",24090,5,2003,2008,10,-124.31929,42.94343,"phos"
"3313",24091,5,2003,2008,10,-124.3339,42.94921,"phos"
"3314",24174,0,2003,2003,1,-123.9071,46.0851,"phos"
"3315",24295,0,2003,2003,1,-123.90767,46.09176,"phos"
"3316",24341,8,2003,2011,9,-117.0573,43.795233,"phos"
"3317",24364,1,2001,2002,4,-121.493611,43.700556,"phos"
"3318",24365,0,2002,2002,1,-121.493611,43.707222,"phos"
"3319",24366,1,2001,2002,3,-121.498333,43.706389,"phos"
"3320",24367,0,2002,2002,1,-121.485556,43.704444,"phos"
"3321",24368,1,2001,2002,3,-121.496667,43.710556,"phos"
"3322",24369,1,2001,2002,2,-121.498056,43.713611,"phos"
"3323",24370,0,2002,2002,1,-121.465278,43.706389,"phos"
"3324",24372,0,2002,2002,1,-121.460833,43.791667,"phos"
"3325",24373,1,2001,2002,3,-121.464583,43.792833,"phos"
"3326",24374,1,2001,2002,2,-121.464583,43.792389,"phos"
"3327",24375,1,2001,2002,3,-121.463972,43.792694,"phos"
"3328",24376,1,2001,2002,6,-121.458611,43.798611,"phos"
"3329",24377,1,2001,2002,3,-121.458611,43.799722,"phos"
"3330",24378,1,2001,2002,2,-121.456944,43.801944,"phos"
"3331",24380,1,2001,2002,2,-121.459543,43.831395,"phos"
"3332",24381,1,2001,2002,2,-121.459194,43.830616,"phos"
"3333",24382,1,2001,2002,7,-121.464052,43.792862,"phos"
"3334",24503,1,2001,2002,2,-121.47607,43.70743,"phos"
"3335",24504,1,2001,2002,3,-121.47622,43.70785,"phos"
"3336",24505,1,2001,2002,4,-121.47728,43.70758,"phos"
"3337",24506,1,2001,2002,2,-121.51961,43.70975,"phos"
"3338",24508,0,2002,2002,1,-121.51908,43.71014,"phos"
"3339",24509,1,2001,2002,2,-121.51677,43.7125,"phos"
"3340",24510,1,2001,2002,2,-121.51719,43.71291,"phos"
"3341",24511,1,2001,2002,2,-121.516065,43.712903,"phos"
"3342",24512,1,2001,2002,2,-121.50083,43.71306,"phos"
"3343",24513,1,2001,2002,2,-121.50056,43.71333,"phos"
"3344",24517,1,2001,2002,2,-121.50023,43.74202,"phos"
"3345",24518,1,2001,2002,2,-121.50044,43.74362,"phos"
"3346",24519,1,2001,2002,2,-121.49929,43.74364,"phos"
"3347",24576,0,2002,2002,1,-121.48088,43.83669,"phos"
"3348",24578,2,2001,2003,13,-121.494631,43.730308,"phos"
"3349",24580,2,2001,2003,17,-121.494496,43.730231,"phos"
"3350",24581,2,2001,2003,14,-121.494503,43.730204,"phos"
"3351",24582,2,2001,2003,12,-121.464119,43.792859,"phos"
"3352",24585,2,2001,2003,13,-121.463913,43.792493,"phos"
"3353",24586,2,2001,2003,18,-121.463982,43.793019,"phos"
"3354",24592,0,2002,2002,1,-123.12846,44.3158,"phos"
"3355",24597,1,2001,2002,5,-121.459773,43.794534,"phos"
"3356",24598,2,2001,2003,12,-121.459472,43.794677,"phos"
"3357",24599,2,2001,2003,13,-121.465437,43.821942,"phos"
"3358",24600,1,2001,2002,5,-121.465284,43.821938,"phos"
"3359",24601,2,2001,2003,13,-121.465281,43.821642,"phos"
"3360",24604,0,2002,2002,1,-122.92536,44.61331,"phos"
"3361",24607,1,2001,2002,11,-121.521171,43.70068,"phos"
"3362",24608,1,2001,2002,5,-121.477183,43.707738,"phos"
"3363",24609,1,2001,2002,5,-121.478097,43.715172,"phos"
"3364",24610,1,2001,2002,2,-121.519353,43.709913,"phos"
"3365",24611,1,2001,2002,8,-121.516251,43.712803,"phos"
"3366",24612,1,2001,2002,5,-121.45929,43.830933,"phos"
"3367",24613,1,2001,2002,7,-121.499226,43.743467,"phos"
"3368",24614,1,2001,2002,8,-121.497529,43.702649,"phos"
"3369",24615,0,2002,2002,3,-121.461357,43.790607,"phos"
"3370",24616,1,2001,2002,2,-121.460158,43.830648,"phos"
"3371",24617,2,2001,2003,14,-121.459385,43.831098,"phos"
"3372",24618,2,2001,2003,16,-121.459356,43.831066,"phos"
"3373",24619,2,2001,2003,19,-121.459337,43.831026,"phos"
"3374",24621,1,2001,2002,3,-121.569532,43.639586,"phos"
"3375",24622,1,2001,2002,5,-121.569551,43.640423,"phos"
"3376",24623,1,2001,2002,3,-121.569551,43.64045,"phos"
"3377",24625,2,2001,2003,16,-121.568061,43.640232,"phos"
"3378",24627,2,2001,2003,15,-121.568106,43.640269,"phos"
"3379",24628,2,2001,2003,15,-121.568306,43.640127,"phos"
"3380",24630,0,2002,2002,1,-121.547567,43.702176,"phos"
"3381",24631,1,2001,2002,3,-121.54643,43.702207,"phos"
"3382",24632,1,2001,2002,3,-121.547207,43.701535,"phos"
"3383",24633,2,2002,2004,15,-121.547263,43.701555,"phos"
"3384",24634,3,2001,2004,23,-121.547058,43.701781,"phos"
"3385",24635,1,2001,2002,4,-121.522216,43.700471,"phos"
"3386",24636,1,2001,2002,3,-121.522209,43.701174,"phos"
"3387",24637,1,2001,2002,3,-121.52121,43.701268,"phos"
"3388",24639,2,2001,2003,16,-121.521416,43.700597,"phos"
"3389",24641,2,2001,2003,16,-121.521494,43.700592,"phos"
"3390",24642,2,2001,2003,15,-121.521424,43.700947,"phos"
"3391",24643,3,2001,2004,23,-121.519032,43.709907,"phos"
"3392",24644,2,2002,2004,20,-121.519575,43.709905,"phos"
"3393",24645,2,2002,2004,14,-121.516173,43.712769,"phos"
"3394",24646,3,2001,2004,20,-121.517581,43.712739,"phos"
"3395",24648,0,2001,2001,1,-121.460742,43.790434,"phos"
"3396",24649,0,2001,2001,2,-121.459396,43.831094,"phos"
"3397",24655,2,2001,2003,17,-121.497325,43.702543,"phos"
"3398",24656,2,2001,2003,17,-121.49733,43.702518,"phos"
"3399",24657,2,2001,2003,30,-121.497359,43.702491,"phos"
"3400",24659,2,2001,2003,13,-121.476727,43.707493,"phos"
"3401",24661,1,2001,2002,2,-121.478107,43.714898,"phos"
"3402",24663,1,2001,2002,3,-121.478113,43.715387,"phos"
"3403",24664,2,2001,2003,13,-121.477723,43.714997,"phos"
"3404",24665,2,2001,2003,15,-121.495002,43.729247,"phos"
"3405",24666,2,2001,2003,15,-121.49539,43.729411,"phos"
"3406",24667,1,2001,2002,6,-121.495338,43.729463,"phos"
"3407",24668,2,2001,2003,11,-121.4598,43.794643,"phos"
"3408",24669,1,2001,2002,4,-121.477374,43.715312,"phos"
"3409",24670,1,2001,2002,2,-121.465205,43.821748,"phos"
"3410",24671,1,2001,2002,3,-121.465179,43.821325,"phos"
"3411",24672,1,2001,2002,3,-121.465463,43.821476,"phos"
"3412",24673,2,2001,2003,13,-121.460764,43.79042,"phos"
"3413",24674,2,2001,2003,14,-121.4608,43.790426,"phos"
"3414",24675,2,2001,2003,18,-121.460854,43.790442,"phos"
"3415",24682,0,2001,2001,2,-121.497326,43.702575,"phos"
"3416",24683,2,2001,2003,14,-121.464178,43.824022,"phos"
"3417",24685,0,2002,2002,2,-123.1973,44.63145,"phos"
"3418",24690,2,2001,2003,14,-121.500523,43.742338,"phos"
"3419",24692,2,2001,2003,14,-121.500523,43.742372,"phos"
"3420",24728,0,2002,2002,1,-122.95059,44.7079,"phos"
"3421",24738,0,2002,2002,1,-123.2099,44.40309,"phos"
"3422",10085,0,2010,2010,2,-123.049056,43.808556,"field  ph"
"3423",10086,0,2010,2010,1,-123.253139,44.921472,"field  ph"
"3424",10087,8,2002,2010,4,-122.709167,42.211111,"field  ph"
"3425",10151,2,2001,2003,23,-123.268611,44.005278,"field  ph"
"3426",10332,11,2001,2012,70,-122.7475,45.577944,"field  ph"
"3427",10339,11,2001,2012,92,-122.690722,45.300333,"field  ph"
"3428",10342,10,2001,2011,21,-122.942361,45.267639,"field  ph"
"3429",10344,11,2001,2012,111,-123.044306,45.090583,"field  ph"
"3430",10346,0,2005,2005,2,-123.041056,44.947167,"field  ph"
"3431",10350,11,2001,2012,153,-123.105778,44.639722,"field  ph"
"3432",10351,0,2010,2010,1,-123.163611,44.638056,"field  ph"
"3433",10352,11,2001,2012,183,-123.255417,44.565528,"field  ph"
"3434",10355,11,2001,2012,126,-123.173667,44.267167,"field  ph"
"3435",10359,11,2001,2012,59,-123.02675,44.045611,"field  ph"
"3436",10360,2,2008,2010,5,-122.600222,45.373528,"field  ph"
"3437",10362,5,2006,2011,64,-122.738028,45.259861,"field  ph"
"3438",10363,11,2001,2012,166,-123.071583,45.223639,"field  ph"
"3439",10364,5,2006,2011,40,-123.1463,44.928,"field  ph"
"3440",10366,11,2001,2012,68,-122.923556,44.636194,"field  ph"
"3441",10372,7,2004,2011,60,-123.111667,44.635556,"field  ph"
"3442",10373,11,2001,2012,72,-123.263639,44.556639,"field  ph"
"3443",10375,4,2004,2008,9,-123.294722,44.313028,"field  ph"
"3444",10376,11,2001,2012,126,-123.046194,44.112722,"field  ph"
"3445",10379,7,2004,2011,15,-122.9655,43.981,"field  ph"
"3446",10386,11,2001,2012,125,-122.905278,43.998194,"field  ph"
"3447",10391,11,2001,2012,65,-123.9135,44.7643,"field  ph"
"3448",10392,5,2001,2006,43,-123.852139,44.030139,"field  ph"
"3449",10393,11,2001,2012,62,-124.136694,43.078528,"field  ph"
"3450",10398,0,2003,2003,1,-116.999361,43.866639,"field  ph"
"3451",10401,1,2005,2006,4,-119.146514,44.415989,"field  ph"
"3452",10404,11,2001,2012,81,-119.035389,45.677444,"field  ph"
"3453",10405,0,2005,2005,2,-118.875611,45.65775,"field  ph"
"3454",10406,11,2001,2012,70,-118.7585,45.674806,"field  ph"
"3455",10407,11,2001,2012,67,-116.972222,44.05675,"field  ph"
"3456",10408,0,2006,2006,4,-117.141361,44.000222,"field  ph"
"3457",10410,11,2001,2012,61,-117.719639,45.621306,"field  ph"
"3458",10411,11,2001,2012,76,-120.910167,45.630222,"field  ph"
"3459",10414,11,2001,2012,88,-124.292167,42.503667,"field  ph"
"3460",10418,11,2001,2012,72,-123.487278,42.496833,"field  ph"
"3461",10421,11,2001,2012,77,-123.089389,42.432694,"field  ph"
"3462",10423,11,2001,2012,90,-122.841583,42.525333,"field  ph"
"3463",10425,0,2002,2002,8,-124.063489,42.548747,"field  ph"
"3464",10428,11,2001,2012,59,-123.455833,42.3975,"field  ph"
"3465",10430,6,2002,2008,64,-122.898833,42.38225,"field  ph"
"3466",10433,6,2002,2008,61,-122.818333,42.280278,"field  ph"
"3467",10434,9,2002,2011,63,-122.744944,42.224417,"field  ph"
"3468",10437,11,2001,2012,61,-123.565833,43.631861,"field  ph"
"3469",10441,11,2001,2012,68,-123.563444,43.635139,"field  ph"
"3470",10442,11,2001,2012,72,-123.411056,43.241778,"field  ph"
"3471",10443,11,2001,2012,69,-123.397944,43.133889,"field  ph"
"3472",10445,3,2003,2006,5,-123.284667,42.944056,"field  ph"
"3473",10451,11,2001,2012,54,-123.409222,43.271861,"field  ph"
"3474",10456,11,2001,2012,69,-122.756278,45.386139,"field  ph"
"3475",10458,11,2001,2012,63,-122.893667,45.409389,"field  ph"
"3476",10459,11,2001,2012,64,-122.919778,45.444415,"field  ph"
"3477",10461,11,2001,2012,64,-122.950556,45.490056,"field  ph"
"3478",10466,0,2008,2008,1,-123.124056,45.477639,"field  ph"
"3479",10469,11,2001,2012,76,-122.752778,45.415472,"field  ph"
"3480",10480,11,2001,2012,59,-122.89875,45.520861,"field  ph"
"3481",10506,11,2001,2012,58,-121.227806,44.761167,"field  ph"
"3482",10508,11,2001,2012,77,-121.293778,44.359917,"field  ph"
"3483",10509,1,2001,2002,7,-121.253861,44.268139,"field  ph"
"3484",10511,11,2001,2012,60,-121.320444,44.060083,"field  ph"
"3485",10517,11,2001,2012,72,-121.080694,44.348694,"field  ph"
"3486",10521,11,2001,2012,62,-123.9251,45.952,"field  ph"
"3487",10523,11,2001,2012,79,-123.8902,45.2071,"field  ph"
"3488",10526,0,2006,2006,3,-124.015139,44.967833,"field  ph"
"3489",10533,11,2001,2012,78,-124.481417,42.81675,"field  ph"
"3490",10535,1,2008,2009,6,-124.352306,42.277056,"field  ph"
"3491",10537,11,2001,2012,88,-124.186139,42.007139,"field  ph"
"3492",10555,11,2001,2012,122,-123.041528,44.946111,"field  ph"
"3493",10565,0,2006,2006,1,-123.099528,44.600278,"field  ph"
"3494",10573,0,2002,2002,2,-121.838333,42.158889,"field  ph"
"3495",10575,0,2002,2002,1,-123.075444,44.662444,"field  ph"
"3496",10577,5,2005,2010,2,-123.080278,44.6445,"field  ph"
"3497",10578,0,2010,2010,3,-123.764444,46.209722,"field  ph"
"3498",10579,6,2004,2010,5,-122.642583,45.440333,"field  ph"
"3499",10580,0,2010,2010,3,-124.217639,43.390556,"field  ph"
"3500",10582,0,2009,2009,2,-124.012583,44.92675,"field  ph"
"3501",10585,1,2007,2008,13,-123.751139,44.376111,"field  ph"
"3502",10588,0,2008,2008,2,-123.875583,44.534556,"field  ph"
"3503",10596,11,2001,2012,76,-124.192528,43.173778,"field  ph"
"3504",10599,0,2002,2002,4,-124.061667,42.58725,"field  ph"
"3505",10602,11,2001,2012,72,-122.855028,42.455444,"field  ph"
"3506",10607,0,2006,2006,6,-122.766694,45.652167,"field  ph"
"3507",10611,11,2001,2012,116,-122.669889,45.513306,"field  ph"
"3508",10616,11,2001,2012,58,-122.738861,45.645639,"field  ph"
"3509",10623,5,2006,2011,62,-122.640694,45.441917,"field  ph"
"3510",10637,11,2001,2012,123,-122.709222,45.267667,"field  ph"
"3511",10638,0,2008,2008,1,-122.537028,45.162694,"field  ph"
"3512",10640,11,2001,2012,67,-122.792528,45.150361,"field  ph"
"3513",10646,5,2005,2010,52,-122.824194,45.006583,"field  ph"
"3514",10647,0,2006,2006,4,-122.767528,44.989889,"field  ph"
"3515",10648,0,2005,2005,5,-122.997111,45.229778,"field  ph"
"3516",10652,0,2003,2003,2,-123.02275,44.945222,"field  ph"
"3517",10655,1,2002,2003,5,-123.037944,44.936111,"field  ph"
"3518",10656,0,2005,2005,3,-123.114583,44.929472,"field  ph"
"3519",10658,5,2006,2011,45,-123.161389,44.730361,"field  ph"
"3520",10659,6,2002,2008,11,-123.235333,44.782778,"field  ph"
"3521",10662,11,2001,2012,89,-122.831222,44.055278,"field  ph"
"3522",10663,11,2001,2012,69,-122.959333,44.092306,"field  ph"
"3523",10674,11,2001,2012,61,-122.375444,45.5385,"field  ph"
"3524",10679,0,2008,2008,1,-121.631111,45.604917,"field  ph"
"3525",10681,1,2008,2009,28,-121.632861,45.604361,"field  ph"
"3526",10684,7,2001,2008,14,-121.410667,43.930806,"field  ph"
"3527",10686,11,2001,2012,64,-121.451194,43.863361,"field  ph"
"3528",10687,1,2001,2002,4,-121.4981,43.8174,"field  ph"
"3529",10688,11,2001,2012,62,-121.607028,43.743417,"field  ph"
"3530",10689,1,2001,2002,4,-121.688722,43.684417,"field  ph"
"3531",10690,11,2001,2012,69,-121.619528,44.5565,"field  ph"
"3532",10694,1,2001,2002,4,-121.463333,43.873028,"field  ph"
"3533",10696,11,2001,2012,55,-121.4513,43.8204,"field  ph"
"3534",10697,1,2001,2002,4,-121.500167,43.692306,"field  ph"
"3535",10698,1,2001,2002,4,-121.572028,43.661806,"field  ph"
"3536",10699,1,2001,2002,4,-121.6516,43.5248,"field  ph"
"3537",10703,8,2001,2009,8,-121.696889,43.463472,"field  ph"
"3538",10705,1,2001,2002,6,-121.5315,43.7943,"field  ph"
"3539",10708,0,2011,2011,3,-120.023139,45.739806,"field  ph"
"3540",10719,11,2001,2012,61,-117.909278,45.566889,"field  ph"
"3541",10720,11,2001,2012,67,-118.235556,45.342111,"field  ph"
"3542",10724,11,2001,2012,62,-117.4675,44.818333,"field  ph"
"3543",10727,0,2006,2006,4,-117.363972,43.939472,"field  ph"
"3544",10728,11,2001,2012,65,-117.229167,43.988056,"field  ph"
"3545",10729,11,2001,2012,64,-117.054333,43.783861,"field  ph"
"3546",10730,4,2008,2012,5,-117.622806,42.840694,"field  ph"
"3547",10741,11,2001,2012,8,-119.901056,42.407139,"field  ph"
"3548",10743,2,2001,2003,6,-120.545028,42.696083,"field  ph"
"3549",10751,7,2001,2008,5,-120.389389,42.19325,"field  ph"
"3550",10758,0,2003,2003,5,-121.560417,42.010278,"field  ph"
"3551",10759,11,2001,2012,65,-121.622667,42.040417,"field  ph"
"3552",10762,0,2003,2003,3,-121.757694,42.154,"field  ph"
"3553",10763,11,2001,2012,72,-121.840722,42.079917,"field  ph"
"3554",10764,11,2001,2012,55,-122.059917,42.086917,"field  ph"
"3555",10765,11,2001,2012,72,-121.927778,42.128056,"field  ph"
"3556",10767,0,2002,2002,4,-121.797722,42.174944,"field  ph"
"3557",10768,11,2001,2012,74,-121.788361,42.218778,"field  ph"
"3558",10770,11,2001,2012,59,-121.916194,42.514611,"field  ph"
"3559",10775,9,2002,2011,56,-123.012861,44.715389,"field  ph"
"3560",10792,11,2001,2012,67,-122.971111,44.708722,"field  ph"
"3561",10801,11,2001,2012,73,-122.709083,45.563806,"field  ph"
"3562",10802,6,2005,2011,64,-122.699972,45.558556,"field  ph"
"3563",10811,0,2003,2003,6,-123.915833,46.168583,"field  ph"
"3564",10812,11,2001,2012,68,-123.924361,46.148972,"field  ph"
"3565",10813,0,2003,2003,3,-123.9089,46.0944,"field  ph"
"3566",10817,11,2001,2012,68,-123.839972,46.075028,"field  ph"
"3567",10821,7,2004,2011,17,-122.763889,45.584722,"field  ph"
"3568",10827,1,2002,2003,4,-122.665778,45.473194,"field  ph"
"3569",10833,4,2007,2011,9,-122.640194,45.340472,"field  ph"
"3570",10853,1,2001,2002,5,-122.568333,45.467778,"field  ph"
"3571",10868,1,2009,2010,17,-122.353306,45.432722,"field  ph"
"3572",10873,5,2006,2011,57,-122.598667,45.364667,"field  ph"
"3573",10886,0,2005,2005,5,-122.756472,45.233639,"field  ph"
"3574",10887,0,2005,2005,1,-122.785278,45.205667,"field  ph"
"3575",10896,5,2002,2007,46,-122.7804,45.1477,"field  ph"
"3576",10898,0,2005,2005,1,-122.671083,45.047278,"field  ph"
"3577",10899,8,2002,2010,116,-122.8225,45.1004,"field  ph"
"3578",10909,0,2008,2008,3,-123.842194,44.731917,"field  ph"
"3579",10916,1,2004,2005,4,-122.654417,45.340528,"field  ph"
"3580",10917,11,2001,2012,140,-122.748972,45.233806,"field  ph"
"3581",10924,3,2007,2010,36,-123.108389,45.240194,"field  ph"
"3582",10929,11,2001,2012,102,-123.17417,45.25194,"field  ph"
"3583",10948,11,2001,2012,74,-123.206917,45.168667,"field  ph"
"3584",10949,1,2008,2009,12,-123.263222,45.107917,"field  ph"
"3585",10952,1,2008,2009,11,-123.4975,45.052167,"field  ph"
"3586",10953,1,2008,2009,11,-123.56125,45.06475,"field  ph"
"3587",10957,0,2008,2008,4,-123.211806,45.116167,"field  ph"
"3588",10958,0,2003,2003,3,-123.265861,45.052667,"field  ph"
"3589",10959,0,2008,2008,3,-123.249222,45.084583,"field  ph"
"3590",10963,3,2006,2009,27,-123.276333,45.126278,"field  ph"
"3591",10967,3,2006,2009,29,-123.438611,45.079389,"field  ph"
"3592",10969,0,2006,2006,1,-123.486,45.079083,"field  ph"
"3593",10983,1,2007,2008,11,-123.658361,43.984639,"field  ph"
"3594",10984,1,2007,2008,10,-123.640028,43.929833,"field  ph"
"3595",10989,1,2007,2008,13,-123.608139,43.998694,"field  ph"
"3596",10990,1,2007,2008,11,-123.6205,43.954889,"field  ph"
"3597",10991,1,2002,2003,4,-122.967528,43.789139,"field  ph"
"3598",10993,1,2002,2003,4,-122.836917,43.695861,"field  ph"
"3599",10996,11,2001,2012,93,-123.459528,43.366361,"field  ph"
"3600",10997,11,2001,2012,76,-123.33575,42.943861,"field  ph"
"3601",11003,0,2005,2005,1,-123.86088,45.229944,"field  ph"
"3602",11017,11,2001,2012,67,-119.637694,44.756,"field  ph"
"3603",11020,11,2001,2012,63,-119.531222,44.465639,"field  ph"
"3604",11043,11,2001,2012,59,-117.268861,43.967306,"field  ph"
"3605",11044,0,2006,2006,3,-117.603722,43.854389,"field  ph"
"3606",11047,9,2003,2012,8,-118.331778,43.783778,"field  ph"
"3607",11050,1,2011,2012,4,-117.518556,42.904917,"field  ph"
"3608",11051,11,2001,2012,129,-122.937722,42.404722,"field  ph"
"3609",11054,5,2006,2011,55,-123.272944,44.556056,"field  ph"
"3610",11111,0,2002,2002,1,-123.46775,44.681778,"field  ph"
"3611",11114,0,2002,2002,1,-123.2915,44.797194,"field  ph"
"3612",11123,6,2002,2008,92,-122.937306,42.403972,"field  ph"
"3613",11125,1,2007,2008,28,-122.924778,42.3895,"field  ph"
"3614",11128,6,2002,2008,100,-122.844667,42.314667,"field  ph"
"3615",11130,6,2002,2008,93,-122.779056,42.245556,"field  ph"
"3616",11133,6,2002,2008,96,-122.652139,42.185472,"field  ph"
"3617",11137,2,2001,2003,21,-123.285528,44.248333,"field  ph"
"3618",11138,2,2001,2003,22,-123.291417,44.216056,"field  ph"
"3619",11140,11,2001,2012,91,-123.294444,44.342861,"field  ph"
"3620",11178,0,2002,2002,2,-121.777333,42.216833,"field  ph"
"3621",11180,11,2001,2012,69,-123.127472,44.620222,"field  ph"
"3622",11182,1,2011,2012,5,-123.107472,44.504611,"field  ph"
"3623",11201,11,2001,2012,78,-122.753056,45.6105,"field  ph"
"3624",11233,11,2001,2012,57,-122.583139,45.378722,"field  ph"
"3625",11240,2,2006,2008,15,-121.547639,45.654806,"field  ph"
"3626",11241,11,2001,2012,199,-123.944972,45.023417,"field  ph"
"3627",11246,0,2008,2008,3,-123.790917,44.742722,"field  ph"
"3628",11262,1,2007,2008,10,-123.941972,44.405306,"field  ph"
"3629",11263,11,2001,2012,75,-123.831,44.382694,"field  ph"
"3630",11275,11,2001,2012,130,-122.985111,44.010028,"field  ph"
"3631",11278,1,2002,2003,5,-123.049139,43.718028,"field  ph"
"3632",11292,0,2011,2011,2,-123.183639,44.853889,"field  ph"
"3633",11304,2,2002,2004,8,-123.337306,43.658306,"field  ph"
"3634",11305,2,2002,2004,4,-123.316139,43.660361,"field  ph"
"3635",11306,3,2002,2005,5,-123.279333,43.604222,"field  ph"
"3636",11309,0,2005,2005,1,-123.301917,43.425472,"field  ph"
"3637",11310,2,2002,2004,10,-123.341361,43.2135,"field  ph"
"3638",11316,0,2004,2004,4,-123.294944,43.022944,"field  ph"
"3639",11321,11,2001,2012,69,-122.64225,45.447167,"field  ph"
"3640",11323,1,2001,2002,3,-122.616111,45.461667,"field  ph"
"3641",11326,1,2001,2002,3,-122.467778,45.486111,"field  ph"
"3642",11375,0,2011,2011,3,-122.698944,42.659361,"field  ph"
"3643",11386,11,2001,2012,65,-120.468639,45.476861,"field  ph"
"3644",11412,1,2007,2008,7,-121.561389,45.499722,"field  ph"
"3645",11428,0,2001,2001,4,-123.843083,45.768361,"field  ph"
"3646",11434,11,2001,2012,75,-123.197583,46.102028,"field  ph"
"3647",11457,11,2001,2012,56,-117.729944,45.619556,"field  ph"
"3648",11476,11,2001,2012,86,-123.834778,44.657667,"field  ph"
"3649",11477,11,2001,2012,78,-120.541139,44.172556,"field  ph"
"3650",11478,11,2001,2012,87,-120.002694,44.792417,"field  ph"
"3651",11479,11,2001,2012,66,-119.470494,44.466331,"field  ph"
"3652",11480,11,2001,2012,71,-117.507583,43.910333,"field  ph"
"3653",11482,11,2001,2012,92,-123.68675,42.238389,"field  ph"
"3654",11483,11,2001,2012,66,-124.185889,42.123722,"field  ph"
"3655",11484,11,2001,2012,89,-123.21575,42.970944,"field  ph"
"3656",11485,11,2001,2012,62,-124.113167,43.032944,"field  ph"
"3657",11486,11,2001,2012,87,-124.149333,43.008528,"field  ph"
"3658",11489,11,2001,2012,66,-119.331944,45.835694,"field  ph"
"3659",11490,11,2001,2012,90,-117.826667,44.781944,"field  ph"
"3660",11491,6,2006,2012,50,-123.861972,43.788778,"field  ph"
"3661",11493,11,2001,2012,117,-124.395556,42.272222,"field  ph"
"3662",11494,11,2001,2012,63,-117.251947,44.356872,"field  ph"
"3663",11495,0,2010,2010,1,-122.891111,44.548333,"field  ph"
"3664",11505,3,2006,2009,39,-123.199583,45.152722,"field  ph"
"3665",11506,6,2002,2008,60,-122.775333,42.245472,"field  ph"
"3666",11514,4,2005,2009,53,-122.783333,45.095333,"field  ph"
"3667",11515,4,2005,2009,58,-122.787222,45.088222,"field  ph"
"3668",11516,0,2010,2010,5,-122.785972,45.086028,"field  ph"
"3669",11521,11,2001,2012,58,-117.962611,45.349722,"field  ph"
"3670",11522,11,2001,2012,77,-123.365556,43.217778,"field  ph"
"3671",11523,6,2002,2008,55,-122.709861,42.215139,"field  ph"
"3672",11527,5,2005,2010,4,-123.178333,45.214444,"field  ph"
"3673",11535,5,2002,2007,27,-122.842361,45.009694,"field  ph"
"3674",11538,0,2010,2010,3,-122.905889,42.438139,"field  ph"
"3675",11539,5,2005,2010,2,-123.116111,44.094722,"field  ph"
"3676",11541,0,2010,2010,3,-124.253056,43.415556,"field  ph"
"3677",11542,0,2005,2005,2,-122.650278,45.424444,"field  ph"
"3678",11543,5,2005,2010,4,-118.838861,45.668556,"field  ph"
"3679",11544,8,2002,2010,4,-122.700028,45.614333,"field  ph"
"3680",11545,8,2002,2010,5,-123.395722,43.211056,"field  ph"
"3681",11547,0,2005,2005,1,-123.053611,45.009444,"field  ph"
"3682",11549,8,2002,2010,4,-121.183889,45.605278,"field  ph"
"3683",11551,5,2005,2010,4,-122.759444,45.404167,"field  ph"
"3684",11555,8,2002,2010,5,-122.656667,45.417778,"field  ph"
"3685",11556,8,2002,2010,4,-123.201111,42.41875,"field  ph"
"3686",11558,0,2002,2002,1,-121.769222,42.197278,"field  ph"
"3687",11571,0,2006,2006,1,-124.105972,43.071667,"field  ph"
"3688",11586,0,2008,2008,2,-117.231772,45.397994,"field  ph"
"3689",11587,0,2008,2008,1,-117.232644,45.398289,"field  ph"
"3690",11598,0,2003,2003,8,-121.790667,42.178444,"field  ph"
"3691",11600,0,2002,2002,3,-121.781694,42.192389,"field  ph"
"3692",11614,6,2002,2008,58,-122.651361,42.193083,"field  ph"
"3693",11626,7,2001,2008,18,-122.402278,45.473056,"field  ph"
"3694",11655,0,2002,2002,2,-122.529528,43.011083,"field  ph"
"3695",11656,0,2002,2002,2,-122.520361,43.010361,"field  ph"
"3696",11698,0,2007,2007,10,-124.189139,43.124528,"field  ph"
"3697",11704,0,2007,2007,12,-124.222139,43.177139,"field  ph"
"3698",11724,0,2007,2007,2,-124.146611,43.06975,"field  ph"
"3699",11725,0,2007,2007,2,-124.193667,43.173583,"field  ph"
"3700",11778,1,2005,2006,11,-120.793333,44.109722,"field  ph"
"3701",11783,0,2010,2010,1,-123.186583,45.855056,"field  ph"
"3702",11823,0,2004,2004,5,-122.802667,45.008417,"field  ph"
"3703",11824,9,2001,2010,2,-122.802694,45.008694,"field  ph"
"3704",11825,0,2004,2004,3,-122.802722,45.008972,"field  ph"
"3705",11826,0,2009,2009,5,-120.599778,45.702889,"field  ph"
"3706",11849,0,2001,2001,5,-123.651778,45.750361,"field  ph"
"3707",11850,0,2007,2007,1,-124.105722,44.186639,"field  ph"
"3708",11856,11,2001,2012,71,-123.842444,45.700361,"field  ph"
"3709",11857,2,2010,2012,76,-117.171833,44.74625,"field  ph"
"3710",11884,1,2006,2007,36,-124.208111,43.356306,"field  ph"
"3711",11904,11,2001,2012,75,-123.751111,46.091167,"field  ph"
"3712",11905,11,2001,2012,75,-124.487889,42.794389,"field  ph"
"3713",11933,8,2002,2010,5,-121.768944,42.196111,"field  ph"
"3714",11935,0,2002,2002,1,-123.799806,45.426222,"field  ph"
"3715",11940,8,2002,2010,6,-122.7695,45.294167,"field  ph"
"3716",11943,1,2005,2006,6,-122.759889,45.293111,"field  ph"
"3717",11967,0,2005,2005,1,-121.543306,45.627167,"field  ph"
"3718",11968,0,2005,2005,4,-121.543222,45.626444,"field  ph"
"3719",11969,0,2005,2005,1,-121.543889,45.627972,"field  ph"
"3720",11971,0,2005,2005,4,-121.512917,45.644222,"field  ph"
"3721",11972,8,2002,2010,91,-121.51517,45.64377,"field  ph"
"3722",11973,0,2005,2005,2,-121.52925,45.627583,"field  ph"
"3723",11974,0,2005,2005,2,-121.527333,45.627722,"field  ph"
"3724",11990,1,2006,2007,2,-122.955222,44.024444,"field  ph"
"3725",12005,11,2001,2012,83,-118.823028,45.654444,"field  ph"
"3726",12012,11,2001,2012,172,-121.506722,45.710722,"field  ph"
"3727",12015,0,2011,2011,4,-119.341281,45.784772,"field  ph"
"3728",12026,1,2011,2012,3,-119.198083,45.74225,"field  ph"
"3729",12042,2,2006,2008,13,-121.664722,45.699167,"field  ph"
"3730",12044,0,2007,2007,1,-121.171111,45.601111,"field  ph"
"3731",12053,0,2001,2001,1,-118.4025,45.2624,"field  ph"
"3732",12054,0,2001,2001,1,-118.4043,45.2627,"field  ph"
"3733",12055,4,2001,2005,6,-118.4287,45.2697,"field  ph"
"3734",12057,4,2001,2005,6,-118.4017,45.2608,"field  ph"
"3735",12058,2,2001,2003,6,-118.5295,45.2699,"field  ph"
"3736",12059,2,2001,2003,5,-118.3828,45.275,"field  ph"
"3737",12061,2,2003,2005,18,-122.762694,44.9865,"field  ph"
"3738",12091,0,2007,2007,1,-123.982389,42.044306,"field  ph"
"3739",12095,0,2007,2007,2,-124.089861,42.048972,"field  ph"
"3740",12099,0,2002,2002,7,-124.231306,42.488083,"field  ph"
"3741",12141,0,2006,2006,1,-118.081944,45.341944,"field  ph"
"3742",12166,0,2006,2006,9,-121.452472,45.704028,"field  ph"
"3743",12181,2,2001,2003,6,-118.533,45.0912,"field  ph"
"3744",12182,2,2001,2003,5,-118.2985,45.107472,"field  ph"
"3745",12183,4,2001,2005,10,-118.3307,45.102556,"field  ph"
"3746",12187,11,2001,2012,64,-123.785583,46.069556,"field  ph"
"3747",12189,0,2005,2005,1,-118.833306,45.671639,"field  ph"
"3748",12212,0,2005,2005,27,-120.716583,44.299083,"field  ph"
"3749",12215,5,2002,2007,2,-123.253833,45.567306,"field  ph"
"3750",12243,0,2006,2006,1,-123.3575,43.071667,"field  ph"
"3751",12244,0,2004,2004,1,-123.287222,43.023889,"field  ph"
"3752",12245,4,2002,2006,11,-123.298333,43.016944,"field  ph"
"3753",12248,0,2004,2004,4,-123.4275,43.117778,"field  ph"
"3754",12251,2,2002,2004,7,-123.385556,43.080861,"field  ph"
"3755",12254,0,2006,2006,4,-123.330917,43.040861,"field  ph"
"3756",12257,2,2001,2003,3,-119.088583,43.652417,"field  ph"
"3757",12258,7,2001,2008,5,-117.729878,43.007536,"field  ph"
"3758",12260,5,2001,2006,4,-117.609444,42.805056,"field  ph"
"3759",12261,11,2001,2012,9,-116.995278,42.911389,"field  ph"
"3760",12262,7,2001,2008,5,-117.180944,42.52625,"field  ph"
"3761",12263,7,2001,2008,5,-117.156389,42.543944,"field  ph"
"3762",12264,11,2001,2012,7,-118.234111,42.337611,"field  ph"
"3763",12265,11,2001,2012,10,-118.866583,42.801083,"field  ph"
"3764",12266,11,2001,2012,11,-119.841944,42.176111,"field  ph"
"3765",12267,11,2001,2012,9,-119.926667,42.174444,"field  ph"
"3766",12269,5,2001,2006,4,-118.369333,42.187167,"field  ph"
"3767",12278,0,2007,2007,1,-123.588278,45.494944,"field  ph"
"3768",12301,0,2008,2008,15,-123.774778,44.635222,"field  ph"
"3769",12303,6,2002,2008,60,-122.866778,42.324833,"field  ph"
"3770",12308,6,2002,2008,92,-122.715722,42.214417,"field  ph"
"3771",12376,6,2002,2008,52,-122.787167,42.253778,"field  ph"
"3772",12377,6,2002,2008,61,-122.870667,42.332722,"field  ph"
"3773",12488,0,2001,2001,3,-121.94731,42.133347,"field  ph"
"3774",12490,0,2003,2003,5,-121.7775,41.996667,"field  ph"
"3775",12509,0,2007,2007,1,-123.439444,44.138889,"field  ph"
"3776",12511,1,2008,2009,7,-123.696222,45.091861,"field  ph"
"3777",12521,0,2007,2007,1,-123.971083,43.963306,"field  ph"
"3778",12534,6,2002,2008,93,-122.738722,42.222722,"field  ph"
"3779",12535,6,2002,2008,95,-122.810056,42.279139,"field  ph"
"3780",12536,6,2002,2008,94,-122.884278,42.36525,"field  ph"
"3781",12537,6,2002,2008,95,-122.924472,42.394417,"field  ph"
"3782",12543,0,2004,2004,2,-121.119278,45.450639,"field  ph"
"3783",12552,11,2001,2012,61,-122.161389,44.174167,"field  ph"
"3784",12553,11,2001,2012,60,-122.411667,44.752778,"field  ph"
"3785",12559,11,2001,2012,76,-122.048611,44.693222,"field  ph"
"3786",12560,1,2001,2002,5,-121.52883,43.77214,"field  ph"
"3787",12561,1,2001,2002,4,-121.305833,44.079167,"field  ph"
"3788",12564,0,2001,2001,1,-121.840194,43.496778,"field  ph"
"3789",12565,1,2001,2002,4,-121.677389,43.520778,"field  ph"
"3790",12566,7,2001,2008,8,-121.333833,44.461306,"field  ph"
"3791",12567,1,2001,2002,4,-121.4761,43.7705,"field  ph"
"3792",12568,2,2008,2010,3,-123.278361,42.942028,"field  ph"
"3793",12569,0,2010,2010,1,-123.279722,42.942694,"field  ph"
"3794",12570,2,2006,2008,5,-123.2805,42.942861,"field  ph"
"3795",12573,0,2002,2002,1,-123.279889,42.942556,"field  ph"
"3796",12578,0,2002,2002,1,-123.891028,45.206028,"field  ph"
"3797",12587,3,2002,2005,43,-122.955806,42.426389,"field  ph"
"3798",12588,6,2002,2008,60,-122.935222,42.3895,"field  ph"
"3799",12590,11,2001,2012,110,-124.451694,42.916278,"field  ph"
"3800",12604,0,2009,2009,1,-124.179806,43.57175,"field  ph"
"3801",12605,0,2009,2009,1,-124.180111,43.571306,"field  ph"
"3802",12617,8,2004,2012,9,-117.828528,44.817083,"field  ph"
"3803",12624,1,2011,2012,10,-117.883944,45.01375,"field  ph"
"3804",12627,1,2011,2012,4,-117.900778,45.034722,"field  ph"
"3805",12655,4,2001,2005,22,-122.339778,44.155444,"field  ph"
"3806",12656,4,2001,2005,24,-122.259139,44.157333,"field  ph"
"3807",12657,4,2001,2005,19,-121.995611,44.35625,"field  ph"
"3808",12692,0,2003,2003,5,-123.929167,46.100278,"field  ph"
"3809",12719,1,2007,2008,26,-122.927056,42.362583,"field  ph"
"3810",12728,1,2007,2008,25,-122.919611,42.362694,"field  ph"
"3811",12796,4,2002,2006,18,-123.240833,43.443306,"field  ph"
"3812",12797,0,2005,2005,1,-123.232833,43.458083,"field  ph"
"3813",12799,0,2005,2005,1,-123.230222,43.449639,"field  ph"
"3814",12800,4,2002,2006,16,-123.3075,43.421111,"field  ph"
"3815",12803,4,2002,2006,20,-123.163861,43.409,"field  ph"
"3816",12807,3,2002,2005,6,-123.324417,43.416333,"field  ph"
"3817",12808,0,2005,2005,1,-123.392944,43.383417,"field  ph"
"3818",12832,0,2007,2007,2,-123.857111,45.501278,"field  ph"
"3819",12841,8,2002,2010,2,-123.855361,45.456944,"field  ph"
"3820",12866,0,2001,2001,4,-123.874444,45.733333,"field  ph"
"3821",12867,0,2001,2001,3,-123.830556,45.785556,"field  ph"
"3822",12868,0,2003,2003,3,-123.168611,44.055556,"field  ph"
"3823",12869,0,2003,2003,2,-123.154444,44.054444,"field  ph"
"3824",12899,2,2004,2006,33,-123.294056,43.022,"field  ph"
"3825",12900,0,2004,2004,4,-123.395278,43.2115,"field  ph"
"3826",12911,7,2002,2009,2,-123.355083,42.949972,"field  ph"
"3827",12913,0,2002,2002,3,-123.3565,42.949556,"field  ph"
"3828",12974,0,2009,2009,1,-123.205556,46.107222,"field  ph"
"3829",12975,0,2009,2009,1,-123.207222,46.107222,"field  ph"
"3830",12978,0,2009,2009,1,-122.943056,46.091667,"field  ph"
"3831",12997,4,2001,2005,6,-118.4174,45.2665,"field  ph"
"3832",13014,11,2001,2012,9,-118.763167,42.63875,"field  ph"
"3833",13039,0,2007,2007,2,-123.841806,45.468194,"field  ph"
"3834",13049,8,2002,2010,2,-123.430639,42.741167,"field  ph"
"3835",13050,8,2002,2010,2,-123.430611,42.738944,"field  ph"
"3836",13051,0,2010,2010,1,-123.430667,42.741417,"field  ph"
"3837",13053,0,2010,2010,1,-123.433639,42.74225,"field  ph"
"3838",13055,0,2006,2006,1,-116.998333,43.902222,"field  ph"
"3839",13056,0,2006,2006,3,-116.982778,43.875278,"field  ph"
"3840",13057,0,2006,2006,3,-116.988056,43.875833,"field  ph"
"3841",13064,0,2006,2006,1,-117.248056,44.354722,"field  ph"
"3842",13065,0,2006,2006,1,-117.250028,44.357167,"field  ph"
"3843",13066,0,2006,2006,1,-117.251917,44.357056,"field  ph"
"3844",13067,0,2006,2006,1,-117.255667,44.356417,"field  ph"
"3845",13070,11,2001,2012,104,-122.360361,45.299389,"field  ph"
"3846",13073,0,2006,2006,1,-122.571806,42.546806,"field  ph"
"3847",13074,0,2006,2006,1,-122.567306,42.547694,"field  ph"
"3848",13075,0,2006,2006,1,-122.568944,42.547778,"field  ph"
"3849",13138,0,2002,2002,17,-121.612639,45.569694,"field  ph"
"3850",13140,0,2008,2008,6,-121.686417,45.556972,"field  ph"
"3851",13141,8,2002,2010,147,-121.524611,45.663722,"field  ph"
"3852",13148,4,2006,2010,24,-121.518972,45.699083,"field  ph"
"3853",13164,0,2006,2006,18,-121.563278,45.509111,"field  ph"
"3854",13171,0,2005,2005,2,-121.522028,45.62875,"field  ph"
"3855",13172,0,2005,2005,2,-121.543694,45.623917,"field  ph"
"3856",13173,0,2005,2005,4,-121.544222,45.631361,"field  ph"
"3857",13181,3,2003,2006,40,-121.585028,45.563583,"field  ph"
"3858",13182,0,2005,2005,16,-121.51525,45.520667,"field  ph"
"3859",13183,1,2005,2006,33,-121.499,45.593806,"field  ph"
"3860",13184,1,2005,2006,32,-121.499167,45.593417,"field  ph"
"3861",13185,0,2008,2008,3,-121.584694,45.662778,"field  ph"
"3862",13186,0,2008,2008,3,-121.550806,45.681611,"field  ph"
"3863",13195,3,2002,2005,3,-123.5225,45.245861,"field  ph"
"3864",13196,2,2003,2005,2,-123.483222,42.523528,"field  ph"
"3865",13216,0,2009,2009,2,-124.007806,43.490444,"field  ph"
"3866",13223,0,2007,2007,2,-123.742306,45.595028,"field  ph"
"3867",13249,0,2010,2010,17,-121.542472,45.642361,"field  ph"
"3868",13263,0,2005,2005,1,-123.971944,44.216139,"field  ph"
"3869",13295,0,2001,2001,3,-123.8821,45.6916,"field  ph"
"3870",13319,0,2008,2008,3,-124.003333,44.893056,"field  ph"
"3871",13364,1,2002,2003,22,-124.06,43.976667,"field  ph"
"3872",13368,0,2012,2012,5,-123.771417,45.722333,"field  ph"
"3873",13386,0,2006,2006,4,-124.208889,43.364167,"field  ph"
"3874",13388,1,2006,2007,27,-124.192778,43.356667,"field  ph"
"3875",13389,1,2006,2007,41,-124.206944,43.301389,"field  ph"
"3876",13405,0,2007,2007,12,-124.277278,43.153972,"field  ph"
"3877",13406,0,2007,2007,15,-124.191306,43.173917,"field  ph"
"3878",13411,11,2001,2012,72,-123.872306,45.575167,"field  ph"
"3879",13417,11,2001,2012,68,-123.842583,45.496306,"field  ph"
"3880",13421,11,2001,2012,60,-123.843111,45.478028,"field  ph"
"3881",13424,11,2001,2012,60,-123.735611,45.471806,"field  ph"
"3882",13428,5,2007,2012,41,-123.843889,45.465278,"field  ph"
"3883",13429,5,2007,2012,38,-123.809167,45.470833,"field  ph"
"3884",13430,5,2007,2012,44,-123.844444,45.459167,"field  ph"
"3885",13431,5,2007,2012,40,-123.85853,45.456389,"field  ph"
"3886",13433,11,2001,2012,60,-123.822778,45.429861,"field  ph"
"3887",13440,11,2001,2012,67,-123.824722,45.408611,"field  ph"
"3888",13540,0,2006,2006,6,-124.192222,43.335556,"field  ph"
"3889",13568,0,2009,2009,2,-124.023333,43.433056,"field  ph"
"3890",13569,0,2009,2009,2,-124.030556,43.425,"field  ph"
"3891",13570,11,2001,2012,76,-124.058583,43.405667,"field  ph"
"3892",13574,11,2001,2012,63,-124.083083,43.363861,"field  ph"
"3893",13583,1,2006,2007,17,-124.204083,43.325778,"field  ph"
"3894",13632,0,2002,2002,1,-123.955556,45.890278,"field  ph"
"3895",13750,1,2002,2003,4,-123.055556,43.711389,"field  ph"
"3896",13769,1,2002,2003,4,-122.95,43.783333,"field  ph"
"3897",13781,0,2002,2002,15,-122.346389,42.378056,"field  ph"
"3898",13782,1,2004,2005,19,-124.505139,42.896361,"field  ph"
"3899",13787,0,2003,2003,9,-124.506778,42.75425,"field  ph"
"3900",13807,1,2003,2004,49,-121.774294,43.925019,"field  ph"
"3901",13945,0,2002,2002,21,-122.154333,43.170278,"field  ph"
"3902",13959,0,2003,2003,5,-123.903056,46.084167,"field  ph"
"3903",14008,11,2001,2012,64,-122.150861,45.162722,"field  ph"
"3904",14018,6,2004,2010,59,-124.118972,43.548111,"field  ph"
"3905",14182,5,2002,2007,2,-124.0585,44.6979,"field  ph"
"3906",14183,0,2002,2002,1,-124.0595,44.697,"field  ph"
"3907",14185,0,2002,2002,1,-124.0593,44.6967,"field  ph"
"3908",14187,5,2002,2007,3,-124.0593,44.6963,"field  ph"
"3909",14192,0,2002,2002,1,-124.058889,44.696111,"field  ph"
"3910",14225,0,2011,2011,1,-122.736944,42.2625,"field  ph"
"3911",14226,0,2011,2011,1,-122.732778,42.268889,"field  ph"
"3912",14228,0,2011,2011,1,-122.735,42.261944,"field  ph"
"3913",14240,8,2002,2010,3,-117.778611,44.708056,"field  ph"
"3914",14241,8,2002,2010,6,-117.783056,44.706111,"field  ph"
"3915",14242,8,2002,2010,5,-117.784167,44.706111,"field  ph"
"3916",14243,8,2002,2010,5,-117.784167,44.704722,"field  ph"
"3917",14244,5,2005,2010,2,-124.355833,43.202778,"field  ph"
"3918",14245,5,2005,2010,2,-124.350278,43.208056,"field  ph"
"3919",14246,5,2005,2010,2,-124.350556,43.207778,"field  ph"
"3920",14247,5,2005,2010,2,-124.356111,43.2025,"field  ph"
"3921",14248,5,2005,2010,2,-124.350833,43.208889,"field  ph"
"3922",14249,5,2005,2010,4,-124.351944,43.206389,"field  ph"
"3923",14254,0,2005,2005,1,-122.878889,45.851389,"field  ph"
"3924",14255,0,2005,2005,1,-122.886111,45.850833,"field  ph"
"3925",14256,0,2005,2005,1,-122.88,45.850556,"field  ph"
"3926",14257,0,2005,2005,1,-122.881389,45.849722,"field  ph"
"3927",14258,0,2005,2005,1,-122.879167,45.85,"field  ph"
"3928",14259,0,2005,2005,2,-122.878889,45.849722,"field  ph"
"3929",14260,0,2005,2005,1,-122.878333,45.849444,"field  ph"
"3930",14263,0,2005,2005,1,-122.881667,45.85,"field  ph"
"3931",14266,0,2002,2002,1,-124.316111,43.205278,"field  ph"
"3932",14267,4,2005,2009,4,-124.316944,43.208611,"field  ph"
"3933",14268,0,2009,2009,1,-124.316389,43.210278,"field  ph"
"3934",14314,0,2002,2002,1,-123.081111,44.922778,"field  ph"
"3935",14320,0,2002,2002,1,-123.078611,44.925833,"field  ph"
"3936",14321,0,2002,2002,1,-123.078611,44.925833,"field  ph"
"3937",14322,0,2002,2002,1,-123.078611,44.925833,"field  ph"
"3938",14334,0,2002,2002,2,-123.091944,44.920833,"field  ph"
"3939",14393,4,2002,2006,3,-123.94616,46.16115,"field  ph"
"3940",14421,0,2001,2001,1,-122.948333,44.023056,"field  ph"
"3941",14422,0,2001,2001,1,-122.945556,44.024167,"field  ph"
"3942",14423,0,2001,2001,1,-122.945556,44.024167,"field  ph"
"3943",14425,0,2009,2009,1,-123.232778,44.696667,"field  ph"
"3944",14429,0,2006,2006,1,-123.236389,44.696667,"field  ph"
"3945",14434,0,2009,2009,1,-123.244444,44.697778,"field  ph"
"3946",14435,0,2006,2006,2,-123.246111,44.699444,"field  ph"
"3947",14444,0,2006,2006,1,-123.239167,44.697222,"field  ph"
"3948",14445,0,2009,2009,1,-123.239167,44.697222,"field  ph"
"3949",14459,0,2006,2006,1,-123.225278,44.699722,"field  ph"
"3950",14460,0,2009,2009,2,-123.227778,44.698611,"field  ph"
"3951",14463,7,2001,2008,6,-120.201528,45.7175,"field  ph"
"3952",14469,0,2009,2009,1,-120.259306,45.625278,"field  ph"
"3953",14473,6,2001,2007,8,-120.252222,45.622417,"field  ph"
"3954",14474,0,2007,2007,1,-120.25225,45.622417,"field  ph"
"3955",14475,9,2001,2010,18,-120.252111,45.622222,"field  ph"
"3956",14476,5,2002,2007,8,-120.255333,45.629333,"field  ph"
"3957",14477,0,2009,2009,1,-120.254917,45.619917,"field  ph"
"3958",14481,0,2001,2001,4,-120.257,45.619917,"field  ph"
"3959",14482,8,2001,2009,3,-120.256944,45.619917,"field  ph"
"3960",14483,0,2008,2008,3,-120.3765,45.618444,"field  ph"
"3961",14488,3,2001,2004,5,-120.251389,45.622778,"field  ph"
"3962",14498,0,2003,2003,1,-120.257111,45.620917,"field  ph"
"3963",14500,6,2001,2007,6,-120.253528,45.622333,"field  ph"
"3964",14509,7,2001,2008,6,-120.287417,45.603194,"field  ph"
"3965",14510,7,2001,2008,8,-120.295528,45.574944,"field  ph"
"3966",14511,7,2001,2008,5,-120.299917,45.572111,"field  ph"
"3967",14530,0,2011,2011,1,-121.519444,43.732222,"field  ph"
"3968",14534,0,2011,2011,1,-121.458333,43.741389,"field  ph"
"3969",14536,0,2011,2011,1,-121.461944,43.768611,"field  ph"
"3970",14540,0,2011,2011,1,-121.433889,43.825833,"field  ph"
"3971",14541,0,2011,2011,1,-121.433611,43.827778,"field  ph"
"3972",14556,0,2011,2011,2,-121.591389,43.613056,"field  ph"
"3973",14557,0,2011,2011,1,-121.574167,43.645833,"field  ph"
"3974",14560,0,2011,2011,1,-121.566667,43.632222,"field  ph"
"3975",14568,0,2011,2011,1,-121.509444,43.679167,"field  ph"
"3976",14569,0,2011,2011,1,-121.603611,43.615278,"field  ph"
"3977",14571,0,2011,2011,1,-121.505,43.646111,"field  ph"
"3978",14573,0,2011,2011,1,-121.505556,43.647222,"field  ph"
"3979",14575,0,2011,2011,1,-121.554444,43.675833,"field  ph"
"3980",14578,0,2011,2011,1,-121.582778,43.700833,"field  ph"
"3981",14579,0,2011,2011,2,-121.579722,43.684722,"field  ph"
"3982",14585,0,2011,2011,1,-121.550833,43.697222,"field  ph"
"3983",14592,0,2011,2011,1,-121.488339,43.716352,"field  ph"
"3984",14593,0,2011,2011,1,-121.488611,43.734444,"field  ph"
"3985",14594,0,2011,2011,1,-121.472222,43.734444,"field  ph"
"3986",14596,0,2011,2011,1,-121.48,43.862778,"field  ph"
"3987",14598,0,2011,2011,1,-121.481111,43.855833,"field  ph"
"3988",14599,0,2011,2011,1,-121.506944,43.76,"field  ph"
"3989",14600,0,2011,2011,2,-121.542222,43.7525,"field  ph"
"3990",14607,0,2011,2011,2,-121.535,43.7725,"field  ph"
"3991",14610,0,2011,2011,1,-121.481944,43.818333,"field  ph"
"3992",14619,0,2011,2011,2,-121.423333,43.822222,"field  ph"
"3993",14620,0,2011,2011,1,-121.461944,43.811944,"field  ph"
"3994",14623,0,2011,2011,1,-121.483056,43.783056,"field  ph"
"3995",14627,0,2011,2011,1,-121.538889,43.740556,"field  ph"
"3996",14632,0,2011,2011,1,-121.541389,43.744167,"field  ph"
"3997",14635,0,2011,2011,1,-121.6043,43.6254,"field  ph"
"3998",14638,0,2011,2011,2,-121.472,43.7328,"field  ph"
"3999",14640,0,2011,2011,1,-121.561944,43.6175,"field  ph"
"4000",14718,0,2011,2011,1,-121.569472,43.791944,"field  ph"
"4001",14719,0,2011,2011,1,-121.573083,43.789722,"field  ph"
"4002",14720,0,2011,2011,1,-121.545306,43.723889,"field  ph"
"4003",14721,0,2011,2011,1,-121.5075,43.670278,"field  ph"
"4004",14722,0,2011,2011,2,-121.514444,43.6775,"field  ph"
"4005",14726,0,2011,2011,1,-121.426667,43.903333,"field  ph"
"4006",14727,0,2011,2011,2,-121.442778,43.862778,"field  ph"
"4007",14728,0,2011,2011,1,-121.554472,43.708611,"field  ph"
"4008",14730,0,2011,2011,1,-121.540028,43.744444,"field  ph"
"4009",14732,0,2003,2003,1,-122.768056,42.376667,"field  ph"
"4010",14734,3,2003,2006,2,-122.774444,42.376111,"field  ph"
"4011",14741,6,2003,2009,3,-122.770833,42.385556,"field  ph"
"4012",14742,0,2009,2009,1,-122.771667,42.375833,"field  ph"
"4013",14743,0,2003,2003,1,-122.773333,42.386667,"field  ph"
"4014",14754,6,2005,2011,2,-122.588889,45.568056,"field  ph"
"4015",14776,0,2003,2003,1,-122.447361,45.55875,"field  ph"
"4016",14804,0,2004,2004,1,-122.806667,45.623056,"field  ph"
"4017",14805,0,2004,2004,1,-122.81,45.624722,"field  ph"
"4018",14806,0,2004,2004,1,-122.811389,45.625833,"field  ph"
"4019",14807,0,2004,2004,1,-122.806389,45.625833,"field  ph"
"4020",14809,6,2002,2008,3,-119.581389,45.686389,"field  ph"
"4021",14810,6,2002,2008,4,-119.586111,45.683611,"field  ph"
"4022",14811,6,2002,2008,3,-119.580833,45.689722,"field  ph"
"4023",14812,6,2002,2008,4,-119.583333,45.690556,"field  ph"
"4024",14813,6,2002,2008,3,-119.601111,45.686389,"field  ph"
"4025",14814,6,2002,2008,4,-119.591389,45.699722,"field  ph"
"4026",14822,5,2007,2012,2,-124.116111,43.984167,"field  ph"
"4027",14823,5,2007,2012,2,-124.118889,43.989167,"field  ph"
"4028",14824,5,2007,2012,4,-124.113889,43.988333,"field  ph"
"4029",14830,6,2004,2010,2,-120.21725,45.657917,"field  ph"
"4030",14831,6,2004,2010,3,-120.223333,45.646778,"field  ph"
"4031",14832,6,2004,2010,5,-120.204972,45.655528,"field  ph"
"4032",14833,6,2004,2010,3,-120.209722,45.661611,"field  ph"
"4033",14857,0,2011,2011,1,-123.271333,42.427333,"field  ph"
"4034",14931,3,2002,2005,2,-122.976667,45.498056,"field  ph"
"4035",14934,3,2002,2005,3,-122.969444,45.495,"field  ph"
"4036",14939,3,2002,2005,3,-122.980278,45.494167,"field  ph"
"4037",14940,8,2002,2010,4,-122.979444,45.495278,"field  ph"
"4038",14941,0,2002,2002,1,-122.978889,45.497222,"field  ph"
"4039",15009,7,2002,2009,3,-124.292222,43.316667,"field  ph"
"4040",15011,0,2006,2006,1,-124.298056,43.321389,"field  ph"
"4041",15012,7,2002,2009,3,-124.298056,43.317778,"field  ph"
"4042",15013,7,2002,2009,2,-124.295833,43.319167,"field  ph"
"4043",15015,7,2002,2009,3,-124.289167,43.318333,"field  ph"
"4044",15016,0,2002,2002,1,-124.297778,43.319444,"field  ph"
"4045",15020,0,2006,2006,1,-124.291111,43.316667,"field  ph"
"4046",15039,0,2003,2003,1,-123.623611,42.214722,"field  ph"
"4047",15116,9,2002,2011,4,-121.250278,44.013056,"field  ph"
"4048",15117,0,2002,2002,1,-121.253889,44.012222,"field  ph"
"4049",15118,0,2002,2002,1,-121.253056,44.008056,"field  ph"
"4050",15119,6,2002,2008,3,-122.8725,45.409722,"field  ph"
"4051",15120,8,2002,2010,4,-122.871944,45.407222,"field  ph"
"4052",15121,8,2002,2010,4,-122.870833,45.408889,"field  ph"
"4053",15122,8,2002,2010,4,-122.870278,45.408333,"field  ph"
"4054",15123,8,2002,2010,5,-122.872778,45.408333,"field  ph"
"4055",15124,8,2002,2010,4,-122.872778,45.408611,"field  ph"
"4056",15125,8,2002,2010,5,-122.869167,45.408333,"field  ph"
"4057",15126,8,2002,2010,5,-122.870833,45.408333,"field  ph"
"4058",15144,11,2001,2012,60,-117.229167,43.988056,"field  ph"
"4059",15151,11,2001,2012,64,-117.035,44.011,"field  ph"
"4060",15155,11,2001,2012,57,-116.955,44.02,"field  ph"
"4061",15169,11,2001,2012,64,-117.01,44.026,"field  ph"
"4062",15174,11,2001,2012,65,-117.023,44.013,"field  ph"
"4063",15180,11,2001,2012,61,-117.011,43.988,"field  ph"
"4064",15183,11,2001,2012,62,-116.99,43.962,"field  ph"
"4065",15186,11,2001,2012,67,-117.023,43.997,"field  ph"
"4066",15201,11,2001,2012,25,-116.995,44.199,"field  ph"
"4067",15203,11,2001,2012,64,-116.963,44.096,"field  ph"
"4068",15216,11,2001,2012,60,-116.985,43.895,"field  ph"
"4069",15217,11,2001,2012,66,-116.994,43.923,"field  ph"
"4070",15221,11,2001,2012,58,-116.993,43.953,"field  ph"
"4071",15229,11,2001,2012,67,-117.078,44.01,"field  ph"
"4072",15233,11,2001,2012,66,-117.268861,43.967306,"field  ph"
"4073",15234,11,2001,2012,39,-117.018,44.019,"field  ph"
"4074",15236,11,2001,2012,71,-117.004,43.931,"field  ph"
"4075",15244,11,2001,2012,39,-117.260194,44.026639,"field  ph"
"4076",15249,11,2001,2012,62,-117.08,43.997,"field  ph"
"4077",15253,11,2001,2012,60,-117.185,44.003,"field  ph"
"4078",15254,11,2001,2012,50,-117.237,43.986,"field  ph"
"4079",15257,11,2001,2012,60,-117.228,43.994,"field  ph"
"4080",15264,11,2001,2012,68,-117.049944,43.995833,"field  ph"
"4081",15275,11,2001,2012,58,-116.99,44.062,"field  ph"
"4082",15280,10,2001,2011,29,-116.989,44.061,"field  ph"
"4083",15284,10,2001,2011,44,-117.2925,43.909722,"field  ph"
"4084",15289,11,2001,2012,58,-116.995,44.198333,"field  ph"
"4085",15291,11,2001,2012,73,-117.175,44.136111,"field  ph"
"4086",15294,11,2001,2012,62,-117.248333,43.966667,"field  ph"
"4087",15302,10,2001,2011,40,-117.061111,43.992222,"field  ph"
"4088",15327,11,2001,2012,59,-117.035278,44.010833,"field  ph"
"4089",15328,11,2001,2012,69,-117.004167,44.230556,"field  ph"
"4090",15329,11,2001,2012,63,-117.004194,43.894444,"field  ph"
"4091",15330,6,2005,2011,2,-122.699167,45.591667,"field  ph"
"4092",15331,6,2005,2011,3,-122.700833,45.591944,"field  ph"
"4093",15361,4,2007,2011,3,-123.396944,42.501389,"field  ph"
"4094",15363,4,2007,2011,2,-123.397222,42.501944,"field  ph"
"4095",15387,4,2007,2011,2,-123.398056,42.504722,"field  ph"
"4096",15446,0,2008,2008,1,-122.580833,45.5625,"field  ph"
"4097",15450,6,2005,2011,2,-122.583889,45.563056,"field  ph"
"4098",15451,3,2005,2008,3,-122.587278,45.566833,"field  ph"
"4099",15452,6,2005,2011,5,-122.585806,45.566556,"field  ph"
"4100",15453,6,2005,2011,3,-122.5845,45.566167,"field  ph"
"4101",15457,3,2005,2008,2,-122.975556,45.282222,"field  ph"
"4102",15459,3,2005,2008,4,-122.973889,45.2825,"field  ph"
"4103",15499,0,2009,2009,2,-122.387778,45.525556,"field  ph"
"4104",15500,0,2009,2009,1,-122.387778,45.523056,"field  ph"
"4105",15508,0,2002,2002,2,-123.105556,44.601944,"field  ph"
"4106",15509,0,2002,2002,1,-123.106389,44.601667,"field  ph"
"4107",15510,0,2002,2002,1,-123.105,44.603056,"field  ph"
"4108",15511,0,2002,2002,1,-123.106111,44.602778,"field  ph"
"4109",15517,11,2001,2012,64,-117.155,43.796,"field  ph"
"4110",15525,7,2001,2008,6,-117.055944,43.796,"field  ph"
"4111",15538,11,2001,2012,66,-117.24425,43.643056,"field  ph"
"4112",15540,11,2001,2012,62,-117.111111,43.780556,"field  ph"
"4113",15541,11,2001,2012,60,-117.145833,43.786111,"field  ph"
"4114",15542,7,2001,2008,2,-124.5075,42.771944,"field  ph"
"4115",15543,0,2008,2008,2,-124.508889,42.769444,"field  ph"
"4116",15546,7,2001,2008,3,-124.505,42.768611,"field  ph"
"4117",15548,0,2008,2008,1,-124.508056,42.767778,"field  ph"
"4118",15569,0,2008,2008,1,-124.071111,43.690833,"field  ph"
"4119",15574,0,2008,2008,1,-124.068056,43.688333,"field  ph"
"4120",15577,0,2008,2008,1,-124.07,43.688333,"field  ph"
"4121",15578,0,2008,2008,1,-124.071389,43.690556,"field  ph"
"4122",15581,0,2008,2008,2,-124.067778,43.688889,"field  ph"
"4123",15611,6,2002,2008,2,-123.246944,45.157778,"field  ph"
"4124",15612,6,2002,2008,2,-123.246944,45.158056,"field  ph"
"4125",15615,6,2002,2008,2,-123.242222,45.160556,"field  ph"
"4126",15617,0,2008,2008,1,-123.25,45.158056,"field  ph"
"4127",15618,0,2008,2008,1,-123.249722,45.157778,"field  ph"
"4128",15619,0,2008,2008,1,-123.243333,45.159444,"field  ph"
"4129",15663,0,2011,2011,1,-123.419444,42.439722,"field  ph"
"4130",15669,0,2011,2011,1,-123.271111,42.425278,"field  ph"
"4131",15682,0,2011,2011,1,-122.830833,42.425278,"field  ph"
"4132",15690,0,2011,2011,1,-122.9325,42.359444,"field  ph"
"4133",15697,0,2006,2006,1,-123.3772,43.1847,"field  ph"
"4134",15700,0,2006,2006,1,-123.3876,43.1851,"field  ph"
"4135",15704,3,2006,2009,2,-123.378611,43.185833,"field  ph"
"4136",15705,3,2006,2009,3,-123.378611,43.185833,"field  ph"
"4137",15719,0,2009,2009,1,-123.381944,43.191389,"field  ph"
"4138",15721,0,2006,2006,1,-123.365278,43.187222,"field  ph"
"4139",15723,3,2006,2009,2,-123.376111,43.184722,"field  ph"
"4140",15724,0,2009,2009,1,-123.375833,43.184444,"field  ph"
"4141",15725,3,2006,2009,3,-123.377778,43.184722,"field  ph"
"4142",15727,0,2009,2009,1,-123.380278,43.186389,"field  ph"
"4143",15755,0,2002,2002,2,-122.591167,45.369,"field  ph"
"4144",15785,3,2006,2009,2,-123.012222,43.954444,"field  ph"
"4145",15789,3,2006,2009,3,-122.997722,43.957,"field  ph"
"4146",15791,3,2006,2009,2,-122.993472,43.956111,"field  ph"
"4147",15798,3,2006,2009,3,-122.991639,43.955861,"field  ph"
"4148",15834,0,2002,2002,1,-121.445,43.782778,"field  ph"
"4149",15835,0,2002,2002,1,-121.446389,43.782778,"field  ph"
"4150",15837,0,2002,2002,1,-121.444861,43.782778,"field  ph"
"4151",15838,0,2002,2002,2,-121.444722,43.783056,"field  ph"
"4152",15866,6,2003,2009,2,-122.949444,42.305833,"field  ph"
"4153",15868,6,2003,2009,2,-122.954722,42.303889,"field  ph"
"4154",15869,6,2003,2009,2,-122.953889,42.304444,"field  ph"
"4155",15870,6,2003,2009,4,-122.954167,42.303611,"field  ph"
"4156",15913,0,2011,2011,1,-122.759167,45.620833,"field  ph"
"4157",15914,0,2011,2011,1,-122.757778,45.618056,"field  ph"
"4158",15916,0,2011,2011,1,-122.761389,45.615833,"field  ph"
"4159",15917,0,2008,2008,2,-122.761389,45.615833,"field  ph"
"4160",15924,0,2011,2011,1,-122.745,45.613056,"field  ph"
"4161",15935,0,2002,2002,1,-122.752333,45.618806,"field  ph"
"4162",15936,6,2002,2008,2,-122.752333,45.618806,"field  ph"
"4163",15937,0,2002,2002,1,-122.744167,45.615444,"field  ph"
"4164",15938,6,2002,2008,2,-122.744167,45.615444,"field  ph"
"4165",15940,9,2002,2011,2,-122.753889,45.618889,"field  ph"
"4166",15941,6,2002,2008,3,-122.745306,45.605694,"field  ph"
"4167",15942,0,2002,2002,1,-122.745306,45.605694,"field  ph"
"4168",15947,3,2008,2011,2,-122.758611,45.618056,"field  ph"
"4169",15949,0,2002,2002,1,-122.743889,45.614306,"field  ph"
"4170",15968,0,2005,2005,1,-123.839722,45.416389,"field  ph"
"4171",15970,0,2005,2005,1,-123.837222,45.416111,"field  ph"
"4172",15971,0,2005,2005,1,-123.836111,45.417222,"field  ph"
"4173",15972,0,2005,2005,1,-123.84,45.408889,"field  ph"
"4174",15978,0,2005,2005,1,-123.836667,45.416667,"field  ph"
"4175",15979,0,2005,2005,1,-123.836667,45.416667,"field  ph"
"4176",15985,0,2005,2005,1,-123.852222,45.415556,"field  ph"
"4177",15986,0,2005,2005,2,-123.85225,45.415556,"field  ph"
"4178",15987,0,2005,2005,1,-123.851944,45.411667,"field  ph"
"4179",15990,0,2005,2005,1,-123.847222,45.416389,"field  ph"
"4180",15992,0,2003,2003,1,-119.667583,45.827861,"field  ph"
"4181",15993,0,2003,2003,1,-119.663944,45.822278,"field  ph"
"4182",16009,0,2009,2009,1,-119.67525,45.818722,"field  ph"
"4183",16016,0,2003,2003,1,-119.49125,45.90075,"field  ph"
"4184",16018,7,2001,2008,24,-119.6881,45.8296,"field  ph"
"4185",16019,11,2001,2012,44,-119.7083,45.8194,"field  ph"
"4186",16022,0,2003,2003,1,-119.534278,45.8935,"field  ph"
"4187",16023,11,2001,2012,59,-119.5315,45.8973,"field  ph"
"4188",16024,11,2001,2012,48,-119.5395,45.9023,"field  ph"
"4189",16026,6,2003,2009,2,-119.504389,45.894417,"field  ph"
"4190",16028,11,2001,2012,45,-119.3282,45.9196,"field  ph"
"4191",16029,1,2001,2002,4,-119.2732,45.8651,"field  ph"
"4192",16030,0,2003,2003,1,-119.244028,45.869056,"field  ph"
"4193",16031,6,2003,2009,2,-119.237111,45.858139,"field  ph"
"4194",16032,0,2003,2003,1,-119.241139,45.839611,"field  ph"
"4195",16035,0,2003,2003,1,-119.169972,45.845889,"field  ph"
"4196",16036,11,2001,2012,50,-119.221,45.8344,"field  ph"
"4197",16037,11,2001,2012,49,-119.2252,45.7856,"field  ph"
"4198",16038,11,2001,2012,53,-119.2168,45.7865,"field  ph"
"4199",16046,11,2001,2012,54,-119.1537,45.8248,"field  ph"
"4200",16047,0,2009,2009,1,-119.244611,45.885361,"field  ph"
"4201",16048,3,2001,2004,14,-119.3098,45.7946,"field  ph"
"4202",16049,0,2003,2003,1,-119.490833,45.8975,"field  ph"
"4203",16053,0,2003,2003,1,-119.368333,45.835278,"field  ph"
"4204",16055,6,2003,2009,2,-119.163889,45.917778,"field  ph"
"4205",16056,1,2001,2002,3,-119.1711,45.9106,"field  ph"
"4206",16063,0,2003,2003,1,-119.3325,45.812778,"field  ph"
"4207",16068,0,2003,2003,1,-119.350833,45.825278,"field  ph"
"4208",16069,0,2003,2003,1,-119.368889,45.783333,"field  ph"
"4209",16070,6,2003,2009,2,-119.328333,45.785556,"field  ph"
"4210",16072,0,2003,2003,2,-119.281111,45.824444,"field  ph"
"4211",16074,11,2001,2012,44,-119.3209,45.8132,"field  ph"
"4212",16075,6,2001,2007,18,-119.6429,45.8288,"field  ph"
"4213",16076,0,2003,2003,1,-119.690833,45.844444,"field  ph"
"4214",16078,1,2001,2002,4,NA,NA,"field  ph"
"4215",16084,11,2001,2012,49,-119.353,45.8291,"field  ph"
"4216",16086,11,2001,2012,50,-119.3817,45.9132,"field  ph"
"4217",16091,0,2003,2003,1,-119.252778,45.816944,"field  ph"
"4218",16093,11,2001,2012,53,-119.4396,45.9055,"field  ph"
"4219",16096,11,2001,2012,53,-119.1896,45.8637,"field  ph"
"4220",16099,11,2001,2012,51,-119.2194,45.8865,"field  ph"
"4221",16100,11,2001,2012,51,-119.1641,45.8467,"field  ph"
"4222",16102,11,2001,2012,55,-119.3884,45.7707,"field  ph"
"4223",16106,11,2001,2012,50,-119.2115,45.8647,"field  ph"
"4224",16109,11,2001,2012,56,-119.3151,45.8232,"field  ph"
"4225",16112,4,2001,2005,15,-119.3268,45.7903,"field  ph"
"4226",16113,6,2003,2009,2,-119.325556,45.784722,"field  ph"
"4227",16114,0,2009,2009,2,-119.262778,45.820278,"field  ph"
"4228",16122,6,2003,2009,2,-119.351944,45.843333,"field  ph"
"4229",16123,11,2001,2012,52,-119.4351,45.7736,"field  ph"
"4230",16126,0,2009,2009,1,-119.372778,45.821944,"field  ph"
"4231",16128,6,2003,2009,2,-119.351667,45.848889,"field  ph"
"4232",16134,11,2001,2012,46,-119.5065,45.8863,"field  ph"
"4233",16146,11,2001,2012,57,-119.2396,45.8358,"field  ph"
"4234",16150,11,2001,2012,45,-119.5597,45.8658,"field  ph"
"4235",16151,0,2009,2009,2,-119.553333,45.888889,"field  ph"
"4236",16154,10,2002,2012,46,-119.5067,45.8988,"field  ph"
"4237",16158,11,2001,2012,50,-119.4756,45.8065,"field  ph"
"4238",16164,0,2009,2009,1,-119.589167,45.876389,"field  ph"
"4239",16167,0,2009,2009,1,-119.64,45.848889,"field  ph"
"4240",16170,11,2001,2012,50,-119.5102,45.8747,"field  ph"
"4241",16175,11,2001,2012,48,-119.343,45.7476,"field  ph"
"4242",16177,11,2001,2012,49,-119.3733,45.6978,"field  ph"
"4243",16180,11,2001,2012,49,-119.1966,45.7317,"field  ph"
"4244",16181,11,2001,2012,56,-119.2105,45.7586,"field  ph"
"4245",16182,0,2009,2009,1,-119.240556,45.747778,"field  ph"
"4246",16184,0,2009,2009,1,-119.540278,45.776389,"field  ph"
"4247",16188,11,2001,2012,55,-119.3728,45.8463,"field  ph"
"4248",16191,11,2001,2012,50,-119.6539,45.8509,"field  ph"
"4249",16192,0,2003,2003,1,-119.494361,45.852472,"field  ph"
"4250",16193,0,2003,2003,1,-119.501083,45.847306,"field  ph"
"4251",16194,0,2003,2003,1,-119.506639,45.859083,"field  ph"
"4252",16195,0,2003,2003,1,-119.499278,45.854722,"field  ph"
"4253",16196,0,2003,2003,1,-119.496972,45.832389,"field  ph"
"4254",16198,0,2009,2009,1,-119.398139,45.852972,"field  ph"
"4255",16203,0,2003,2003,1,-119.495611,45.85875,"field  ph"
"4256",16204,0,2003,2003,1,-119.506722,45.84575,"field  ph"
"4257",16205,0,2003,2003,1,-119.503722,45.841,"field  ph"
"4258",16207,0,2003,2003,1,-119.497389,45.843972,"field  ph"
"4259",16208,7,2003,2010,2,-119.453083,45.851944,"field  ph"
"4260",16209,0,2009,2009,1,-119.389944,45.8495,"field  ph"
"4261",16212,0,2009,2009,1,-119.397056,45.846083,"field  ph"
"4262",16214,7,2003,2010,3,-119.428472,45.828583,"field  ph"
"4263",16215,7,2003,2010,2,-119.428639,45.828639,"field  ph"
"4264",16218,7,2003,2010,2,-119.438278,45.837306,"field  ph"
"4265",16224,0,2009,2009,1,-119.380472,45.858,"field  ph"
"4266",16225,0,2009,2009,1,-119.372139,45.864,"field  ph"
"4267",16226,0,2009,2009,1,-119.357778,45.858306,"field  ph"
"4268",16227,0,2009,2009,1,-119.359806,45.858278,"field  ph"
"4269",16228,0,2009,2009,2,-119.378694,45.857972,"field  ph"
"4270",16229,0,2009,2009,1,-119.383139,45.769639,"field  ph"
"4271",16230,0,2009,2009,1,-119.439139,45.748167,"field  ph"
"4272",16231,0,2009,2009,1,-119.407139,45.730306,"field  ph"
"4273",16232,0,2009,2009,1,-119.347833,45.740917,"field  ph"
"4274",16233,0,2009,2009,1,-119.358056,45.864083,"field  ph"
"4275",16234,0,2009,2009,1,-119.232611,45.780722,"field  ph"
"4276",16235,0,2009,2009,1,-119.315528,45.797139,"field  ph"
"4277",16236,0,2009,2009,1,-119.315167,45.792972,"field  ph"
"4278",16237,0,2010,2010,1,-119.315167,45.792972,"field  ph"
"4279",16238,0,2010,2010,1,-119.287139,45.791944,"field  ph"
"4280",16240,0,2009,2009,1,-119.301722,45.792611,"field  ph"
"4281",16242,0,2010,2010,1,-119.32175,45.773611,"field  ph"
"4282",16245,0,2010,2010,1,-119.351444,45.759278,"field  ph"
"4283",16248,0,2010,2010,1,-119.293472,45.794167,"field  ph"
"4284",16249,0,2009,2009,1,-119.232583,45.781,"field  ph"
"4285",16250,0,2009,2009,1,-119.226333,45.782806,"field  ph"
"4286",16251,0,2009,2009,2,-119.315528,45.797167,"field  ph"
"4287",16252,0,2009,2009,1,-119.226583,45.782861,"field  ph"
"4288",16253,6,2003,2009,2,-119.225083,45.806333,"field  ph"
"4289",16254,6,2003,2009,4,-119.235694,45.82025,"field  ph"
"4290",16255,6,2003,2009,2,-119.224694,45.820056,"field  ph"
"4291",16256,7,2003,2010,2,-119.473528,45.897889,"field  ph"
"4292",16257,7,2003,2010,3,-119.474639,45.898944,"field  ph"
"4293",16258,7,2003,2010,2,-119.475972,45.900028,"field  ph"
"4294",16261,0,2010,2010,1,-119.870833,45.704333,"field  ph"
"4295",16263,0,2010,2010,2,-119.833306,45.720694,"field  ph"
"4296",16266,0,2003,2003,1,-119.494833,45.836389,"field  ph"
"4297",16269,0,2003,2003,1,-119.22,45.882222,"field  ph"
"4298",16272,5,2003,2008,2,-124.0715,44.3995,"field  ph"
"4299",16273,5,2003,2008,2,-124.0711,44.4013,"field  ph"
"4300",16275,5,2003,2008,3,-124.0711,44.3999,"field  ph"
"4301",16276,5,2003,2008,2,-124.0709,44.3999,"field  ph"
"4302",16278,5,2003,2008,2,-124.071,44.3998,"field  ph"
"4303",16280,5,2003,2008,3,-124.0686,44.4024,"field  ph"
"4304",16534,0,2009,2009,1,-123.221111,44.233611,"field  ph"
"4305",16536,0,2009,2009,1,-123.203889,44.239167,"field  ph"
"4306",16537,7,2002,2009,4,-123.219444,44.25,"field  ph"
"4307",16543,0,2009,2009,1,-123.176389,44.222222,"field  ph"
"4308",16545,7,2002,2009,4,-123.245,44.25249,"field  ph"
"4309",16553,7,2002,2009,5,-123.18777,44.207779,"field  ph"
"4310",16591,0,2009,2009,1,-122.991667,44.590556,"field  ph"
"4311",16649,0,2009,2009,1,-123.12355,44.18477,"field  ph"
"4312",16650,0,2009,2009,1,-123.12949,44.18862,"field  ph"
"4313",16655,0,2009,2009,1,-123.12239,44.18861,"field  ph"
"4314",16656,4,2002,2006,3,-123.0744,44.13537,"field  ph"
"4315",16658,7,2002,2009,3,-123.0946,44.13508,"field  ph"
"4316",16660,7,2002,2009,5,-123.0974,44.14236,"field  ph"
"4317",16677,0,2001,2001,1,-122.856389,45.174167,"field  ph"
"4318",16696,0,2001,2001,1,-122.859167,45.178611,"field  ph"
"4319",16697,7,2003,2010,4,-122.855556,45.178056,"field  ph"
"4320",16699,0,2001,2001,1,-122.859083,45.173389,"field  ph"
"4321",16701,9,2001,2010,5,-122.860556,45.179444,"field  ph"
"4322",16705,0,2010,2010,1,-122.856389,45.180833,"field  ph"
"4323",16708,0,2001,2001,1,-122.858889,45.174444,"field  ph"
"4324",16709,0,2001,2001,1,-122.858056,45.173333,"field  ph"
"4325",16718,0,2011,2011,2,-122.7325,42.263611,"field  ph"
"4326",16719,0,2011,2011,1,-122.736389,42.262778,"field  ph"
"4327",16721,0,2011,2011,1,-122.736111,42.261389,"field  ph"
"4328",16727,7,2002,2009,4,-124.318333,43.209167,"field  ph"
"4329",16732,3,2003,2006,2,-123.112778,44.098333,"field  ph"
"4330",16733,3,2003,2006,2,-123.106667,44.1075,"field  ph"
"4331",16734,3,2003,2006,2,-123.106111,44.107778,"field  ph"
"4332",16737,3,2003,2006,3,-123.108611,44.104167,"field  ph"
"4333",16738,3,2003,2006,3,-123.111111,44.100556,"field  ph"
"4334",16739,3,2006,2009,2,-122.771111,42.383333,"field  ph"
"4335",16740,3,2003,2006,2,-122.771389,42.383611,"field  ph"
"4336",16741,0,2006,2006,1,-122.772222,42.383333,"field  ph"
"4337",16742,0,2007,2007,1,-123.3382,43.3371,"field  ph"
"4338",16743,0,2007,2007,1,-123.337778,43.335833,"field  ph"
"4339",16754,7,2002,2009,4,-124.297222,43.318333,"field  ph"
"4340",16756,0,2002,2002,1,-124.298333,43.318889,"field  ph"
"4341",16757,0,2003,2003,2,-123.624722,42.213611,"field  ph"
"4342",16758,0,2003,2003,1,-123.625,42.215556,"field  ph"
"4343",16759,9,2002,2011,6,-121.747778,42.236111,"field  ph"
"4344",16760,9,2002,2011,6,-121.747778,42.233056,"field  ph"
"4345",16761,9,2002,2011,6,-121.751667,42.2325,"field  ph"
"4346",16762,9,2002,2011,7,-121.754722,42.232222,"field  ph"
"4347",16772,6,2003,2009,2,-122.952778,42.305556,"field  ph"
"4348",16997,0,2005,2005,2,-120.860444,44.301972,"field  ph"
"4349",17164,0,2002,2002,2,-122.857361,42.963389,"field  ph"
"4350",18741,5,2006,2011,61,-122.659722,45.41,"field  ph"
"4351",18742,5,2006,2011,55,-122.662722,45.465278,"field  ph"
"4352",18774,0,2001,2001,1,-124.105528,44.265667,"field  ph"
"4353",18775,0,2001,2001,1,-123.845472,44.319833,"field  ph"
"4354",18789,0,2002,2002,1,-123.611389,42.80375,"field  ph"
"4355",18790,0,2002,2002,1,-123.588667,42.817667,"field  ph"
"4356",18796,0,2001,2001,1,-123.7928,44.7456,"field  ph"
"4357",18797,0,2001,2001,1,-123.9003,45.1404,"field  ph"
"4358",18802,0,2001,2001,4,-123.769111,45.813472,"field  ph"
"4359",18803,0,2001,2001,2,-123.765083,43.806222,"field  ph"
"4360",18804,6,2001,2007,8,-124.10825,44.224194,"field  ph"
"4361",18821,0,2003,2003,2,-124.427583,42.965917,"field  ph"
"4362",18822,0,2003,2003,2,-124.414333,43.003361,"field  ph"
"4363",18823,0,2003,2003,3,-124.41375,43.052083,"field  ph"
"4364",18824,0,2003,2003,2,-124.423417,42.975472,"field  ph"
"4365",20389,0,2001,2001,3,-123.779472,45.827167,"field  ph"
"4366",20391,0,2005,2005,1,-124.067333,42.8885,"field  ph"
"4367",20392,0,2005,2005,1,-124.06725,42.88875,"field  ph"
"4368",20394,6,2005,2011,8,-124.067417,42.888111,"field  ph"
"4369",20422,6,2002,2008,3,-119.308333,45.886111,"field  ph"
"4370",20423,6,2002,2008,6,-119.305278,45.886111,"field  ph"
"4371",20424,6,2002,2008,3,-119.309722,45.89,"field  ph"
"4372",20440,0,2001,2001,4,-123.845556,45.695306,"field  ph"
"4373",20447,5,2004,2009,26,-124.096472,43.595028,"field  ph"
"4374",20835,0,2003,2003,2,-123.142611,44.054389,"field  ph"
"4375",20846,0,2003,2003,1,-123.134306,44.059944,"field  ph"
"4376",21506,0,2002,2002,2,-122.551833,42.997944,"field  ph"
"4377",21535,1,2011,2012,6,-121.500333,42.462,"field  ph"
"4378",21790,0,2002,2002,2,-123.979761,44.499656,"field  ph"
"4379",21791,5,2002,2007,6,-124.105811,44.170708,"field  ph"
"4380",21792,0,2003,2003,2,-123.92875,44.580669,"field  ph"
"4381",21794,3,2002,2005,3,-124.305169,42.804089,"field  ph"
"4382",21797,2,2003,2005,2,-124.185911,42.974633,"field  ph"
"4383",21799,0,2002,2002,1,-124.029111,42.768633,"field  ph"
"4384",21800,0,2011,2011,7,-123.55045,45.277942,"field  ph"
"4385",21804,3,2002,2005,2,-123.621869,45.228936,"field  ph"
"4386",21805,3,2002,2005,3,-123.830931,45.351989,"field  ph"
"4387",21806,0,2002,2002,1,-123.822639,45.284822,"field  ph"
"4388",21807,0,2002,2002,2,-123.8835,45.912014,"field  ph"
"4389",21811,3,2002,2005,4,-123.51585,45.585806,"field  ph"
"4390",21812,0,2002,2002,1,-123.490039,45.552708,"field  ph"
"4391",21813,0,2002,2002,2,-123.284581,45.736719,"field  ph"
"4392",21814,4,2001,2005,2,-123.91125,42.174153,"field  ph"
"4393",21822,3,2002,2005,5,-123.238861,42.101917,"field  ph"
"4394",21832,0,2002,2002,2,-122.251917,44.437386,"field  ph"
"4395",21833,0,2002,2002,1,-122.736606,44.258794,"field  ph"
"4396",21835,4,2001,2005,5,-122.101831,44.782844,"field  ph"
"4397",21839,3,2002,2005,5,-122.889283,43.740583,"field  ph"
"4398",21841,0,2002,2002,1,-123.125125,45.508128,"field  ph"
"4399",21842,1,2007,2008,3,-123.851073,44.538726,"field  ph"
"4400",21848,0,2007,2007,1,-123.979692,42.045169,"field  ph"
"4401",21849,0,2007,2007,1,-124.034286,42.573014,"field  ph"
"4402",21877,0,2008,2008,3,-121.7812,45.464478,"field  ph"
"4403",22369,0,2011,2011,3,-123.706519,45.277064,"field  ph"
"4404",22375,0,2011,2011,6,-123.603114,45.239361,"field  ph"
"4405",22383,0,2011,2011,7,-123.580667,45.265833,"field  ph"
"4406",22386,0,2008,2008,1,-123.168453,45.436233,"field  ph"
"4407",22394,0,2011,2011,6,-123.818167,45.2765,"field  ph"
"4408",22569,2,2001,2003,12,-121.464178,43.824022,"field  ph"
"4409",22571,0,2002,2002,1,-121.464156,43.824003,"field  ph"
"4410",22572,2,2001,2003,21,-121.464147,43.823897,"field  ph"
"4411",22573,2,2001,2003,10,-121.464156,43.823744,"field  ph"
"4412",22574,2,2001,2003,9,-121.464642,43.823903,"field  ph"
"4413",22651,5,2001,2006,34,-122.7605,44.254167,"field  ph"
"4414",22654,5,2001,2006,34,-122.854083,44.172861,"field  ph"
"4415",22667,0,2002,2002,1,-124.243419,43.436939,"field  ph"
"4416",22668,0,2002,2002,1,-124.238749,43.43694,"field  ph"
"4417",22669,0,2002,2002,1,-124.244882,43.436594,"field  ph"
"4418",22670,0,2002,2002,1,-124.243561,43.436594,"field  ph"
"4419",22671,0,2002,2002,1,-124.240966,43.436422,"field  ph"
"4420",22672,4,2002,2006,2,-124.241013,43.436491,"field  ph"
"4421",22673,0,2002,2002,1,-124.24587,43.434834,"field  ph"
"4422",22674,4,2002,2006,2,-124.244879,43.434282,"field  ph"
"4423",22675,4,2002,2006,4,-124.243888,43.434351,"field  ph"
"4424",22676,0,2004,2004,1,-123.426725,43.103019,"field  ph"
"4425",22677,0,2004,2004,1,-123.426539,43.100265,"field  ph"
"4426",22678,0,2004,2004,1,-123.426539,43.098648,"field  ph"
"4427",22679,0,2004,2004,1,-123.426304,43.099508,"field  ph"
"4428",22680,0,2004,2004,1,-123.426256,43.102881,"field  ph"
"4429",22681,5,2005,2010,4,-120.254125,45.621565,"field  ph"
"4430",22683,0,2002,2002,1,-122.744444,45.612222,"field  ph"
"4431",22684,5,2005,2010,3,-121.136719,45.560133,"field  ph"
"4432",22685,5,2005,2010,3,-121.138153,45.563756,"field  ph"
"4433",22687,2,2005,2007,2,-121.130381,45.561053,"field  ph"
"4434",22689,2,2005,2007,3,-121.141683,45.561742,"field  ph"
"4435",22691,0,2010,2010,2,-121.141272,45.565861,"field  ph"
"4436",22692,6,2005,2011,2,-122.699583,45.593611,"field  ph"
"4437",22696,6,2006,2012,3,-118.475833,45.9575,"field  ph"
"4438",22697,6,2006,2012,4,-118.480833,45.961667,"field  ph"
"4439",22698,6,2006,2012,5,-118.483333,45.958056,"field  ph"
"4440",22699,4,2002,2006,3,-121.251389,44.010556,"field  ph"
"4441",22700,9,2002,2011,2,-121.258889,44.010278,"field  ph"
"4442",22701,5,2006,2011,4,-121.446111,43.782778,"field  ph"
"4443",22702,5,2006,2011,4,-121.445,43.781667,"field  ph"
"4444",22705,5,2006,2011,3,-121.444722,43.782222,"field  ph"
"4445",22715,0,2002,2002,1,-122.995,44.900278,"field  ph"
"4446",22716,7,2002,2009,4,-122.998056,44.901389,"field  ph"
"4447",22719,7,2002,2009,4,-122.993889,44.897222,"field  ph"
"4448",22721,6,2003,2009,3,-122.770278,42.386111,"field  ph"
"4449",22954,0,2001,2001,2,-123.231222,46.128944,"field  ph"
"4450",22965,0,2005,2005,2,-121.495472,45.651611,"field  ph"
"4451",22966,0,2005,2005,1,-121.495667,45.651639,"field  ph"
"4452",22970,0,2005,2005,2,-121.543528,45.635028,"field  ph"
"4453",22971,0,2005,2005,1,-121.534306,45.628639,"field  ph"
"4454",22972,0,2005,2005,2,-121.530056,45.627278,"field  ph"
"4455",22973,0,2005,2005,2,-121.529611,45.627278,"field  ph"
"4456",22974,0,2005,2005,2,-121.528,45.627278,"field  ph"
"4457",22978,0,2005,2005,2,-121.518778,45.638889,"field  ph"
"4458",22985,0,2005,2005,1,-118.84027,45.668152,"field  ph"
"4459",22986,0,2005,2005,1,-118.84195,45.66786,"field  ph"
"4460",23038,0,2005,2005,1,-118.83934,45.66825,"field  ph"
"4461",23070,6,2002,2008,60,-122.851722,42.318083,"field  ph"
"4462",23160,4,2004,2008,2,-123.098056,43.303056,"field  ph"
"4463",23161,4,2004,2008,3,-123.100556,43.303056,"field  ph"
"4464",23162,4,2004,2008,3,-123.100556,43.305,"field  ph"
"4465",23163,4,2004,2008,2,-123.099444,43.305556,"field  ph"
"4466",23172,3,2001,2004,5,-122.86916,45.181111,"field  ph"
"4467",23176,1,2003,2004,2,-122.86,45.181667,"field  ph"
"4468",23195,11,2001,2012,58,-116.995,44.198333,"field  ph"
"4469",23196,2,2006,2008,2,-118.116667,45.3525,"field  ph"
"4470",23197,6,2002,2008,3,-118.121667,45.348333,"field  ph"
"4471",23198,6,2002,2008,5,-118.121944,45.347778,"field  ph"
"4472",23202,0,2002,2002,1,-118.121806,45.347917,"field  ph"
"4473",23242,0,2001,2001,2,-123.95,44.020833,"field  ph"
"4474",23260,4,2007,2011,3,-123.39694,42.498055,"field  ph"
"4475",23296,0,2005,2005,20,-123.4348096,45.8215724,"field  ph"
"4476",23317,0,2001,2001,1,-118.8034,45.665,"field  ph"
"4477",23318,0,2001,2001,1,-118.8037,45.665,"field  ph"
"4478",23319,0,2001,2001,1,-118.8038,45.6652,"field  ph"
"4479",23320,0,2001,2001,1,-118.8035,45.6652,"field  ph"
"4480",23321,0,2011,2011,1,-121.55307,43.68474,"field  ph"
"4481",23402,1,2002,2003,2,-123.999406,42.454753,"field  ph"
"4482",23408,0,2002,2002,2,-124.037414,42.514094,"field  ph"
"4483",23438,0,2011,2011,1,-121.4952778,43.700833,"field  ph"
"4484",23443,0,2011,2011,1,-121.4653,43.86283,"field  ph"
"4485",23445,0,2011,2011,1,-121.47556,43.70802,"field  ph"
"4486",23487,5,2005,2010,33,-118.165106,45.829289,"field  ph"
"4487",23492,5,2005,2010,36,-118.333181,45.900972,"field  ph"
"4488",23497,0,2011,2011,3,-118.378722,46,"field  ph"
"4489",23509,0,2012,2012,5,-123.589979,45.84384,"field  ph"
"4490",23523,0,2001,2001,2,-123.375643,46.132539,"field  ph"
"4491",23538,0,2001,2001,2,-123.081763,46.041327,"field  ph"
"4492",23539,0,2001,2001,3,-123.038425,45.988468,"field  ph"
"4493",23737,11,2001,2012,59,-116.99405,44.242883,"field  ph"
"4494",23744,7,2002,2009,77,-124.033975,44.294306,"field  ph"
"4495",23745,7,2002,2009,76,-123.973897,44.297889,"field  ph"
"4496",23746,7,2002,2009,76,-123.97686,44.296922,"field  ph"
"4497",23747,7,2002,2009,77,-123.976861,44.316914,"field  ph"
"4498",23748,7,2002,2009,76,-123.974386,44.316914,"field  ph"
"4499",23749,7,2002,2009,77,-123.939722,44.288694,"field  ph"
"4500",23750,7,2002,2009,59,-123.96171,44.277481,"field  ph"
"4501",23751,7,2002,2009,77,-123.960472,44.277514,"field  ph"
"4502",23752,6,2003,2009,66,-124.027139,44.296789,"field  ph"
"4503",23753,6,2003,2009,19,-124.407222,42.371944,"field  ph"
"4504",23758,5,2001,2006,13,-123.460747,42.39476,"field  ph"
"4505",23759,5,2001,2006,10,-123.538817,42.363161,"field  ph"
"4506",23760,5,2001,2006,13,-123.579786,42.363942,"field  ph"
"4507",23761,0,2003,2003,6,-124.494653,42.764017,"field  ph"
"4508",23764,1,2001,2002,26,-122.687853,42.459283,"field  ph"
"4509",23765,0,2002,2002,2,-122.811075,42.537853,"field  ph"
"4510",23793,1,2004,2005,8,-122.02835,45.614216,"field  ph"
"4511",23797,2,2001,2003,13,-122.826317,45.970117,"field  ph"
"4512",23800,2,2001,2003,14,-123.4242,46.220683,"field  ph"
"4513",23810,2,2006,2008,13,-122.611817,45.602366,"field  ph"
"4514",23812,0,2008,2008,2,-122.60665,45.60793,"field  ph"
"4515",23815,0,2003,2003,1,-123.846842,45.897376,"field  ph"
"4516",23816,0,2003,2003,1,-123.754676,45.545668,"field  ph"
"4517",23819,0,2003,2003,1,-123.488,45.4743,"field  ph"
"4518",23821,0,2003,2003,1,-123.68697,44.197048,"field  ph"
"4519",23823,0,2003,2003,1,-123.9838,44.085856,"field  ph"
"4520",23836,3,2002,2005,4,-123.39559,42.781741,"field  ph"
"4521",23837,3,2002,2005,4,-123.60948,43.45645,"field  ph"
"4522",23839,0,2003,2003,1,-123.20991,42.602606,"field  ph"
"4523",23840,0,2007,2007,2,-123.5701,42.655431,"field  ph"
"4524",23843,0,2007,2007,1,-123.23909,42.07499,"field  ph"
"4525",23847,4,2001,2005,4,-122.3852,44.427415,"field  ph"
"4526",23849,0,2003,2003,2,-122.28915,44.852973,"field  ph"
"4527",23851,0,2001,2001,2,-121.999052,44.57005,"field  ph"
"4528",23853,0,2003,2003,1,-123.350797,45.173487,"field  ph"
"4529",23854,0,2003,2003,1,-123.55147,45.000534,"field  ph"
"4530",23857,0,2003,2003,1,-122.677977,43.620848,"field  ph"
"4531",23859,2,2001,2003,21,-123.393163,44.265533,"field  ph"
"4532",23863,0,2007,2007,2,-123.311606,44.415841,"field  ph"
"4533",23864,0,2006,2006,1,-122.795884,44.966953,"field  ph"
"4534",23870,3,2001,2004,14,-123.065739,42.230231,"field  ph"
"4535",23892,2,2005,2007,20,-122.99812,43.32422,"field  ph"
"4536",23897,2,2005,2007,21,-122.54524,43.29207,"field  ph"
"4537",23934,0,2001,2001,4,-123.003313,45.899925,"field  ph"
"4538",24037,0,2003,2003,5,-123.918611,46.128611,"field  ph"
"4539",24090,0,2003,2003,1,-124.31929,42.94343,"field  ph"
"4540",24091,0,2003,2003,1,-124.3339,42.94921,"field  ph"
"4541",24174,0,2003,2003,1,-123.9071,46.0851,"field  ph"
"4542",24295,0,2003,2003,1,-123.90767,46.09176,"field  ph"
"4543",24302,1,2007,2008,10,-121.50892,44.32117,"field  ph"
"4544",24303,1,2007,2008,18,-121.38515,44.41979,"field  ph"
"4545",24317,0,2008,2008,11,-121.54399,44.28799,"field  ph"
"4546",24318,0,2008,2008,7,-121.56712,44.23359,"field  ph"
"4547",24341,11,2001,2012,57,-117.0573,43.795233,"field  ph"
"4548",24344,0,2005,2005,1,NA,NA,"field  ph"
"4549",24349,0,2003,2003,1,-123.91404,46.0957,"field  ph"
"4550",24364,2,2001,2003,9,-121.493611,43.700556,"field  ph"
"4551",24365,0,2002,2002,1,-121.493611,43.707222,"field  ph"
"4552",24366,2,2001,2003,8,-121.498333,43.706389,"field  ph"
"4553",24367,0,2002,2002,1,-121.485556,43.704444,"field  ph"
"4554",24368,2,2001,2003,9,-121.496667,43.710556,"field  ph"
"4555",24369,2,2001,2003,9,-121.498056,43.713611,"field  ph"
"4556",24370,1,2002,2003,7,-121.465278,43.706389,"field  ph"
"4557",24371,1,2002,2003,7,-121.460278,43.706389,"field  ph"
"4558",24372,1,2002,2003,8,-121.460833,43.791667,"field  ph"
"4559",24373,2,2001,2003,9,-121.464583,43.792833,"field  ph"
"4560",24374,2,2001,2003,7,-121.464583,43.792389,"field  ph"
"4561",24375,2,2001,2003,9,-121.463972,43.792694,"field  ph"
"4562",24376,2,2001,2003,12,-121.458611,43.798611,"field  ph"
"4563",24377,2,2001,2003,9,-121.458611,43.799722,"field  ph"
"4564",24378,1,2001,2002,2,-121.456944,43.801944,"field  ph"
"4565",24379,0,2003,2003,4,-121.83316,43.82444,"field  ph"
"4566",24380,2,2001,2003,9,-121.459543,43.831395,"field  ph"
"4567",24381,1,2001,2002,2,-121.459194,43.830616,"field  ph"
"4568",24382,2,2001,2003,22,-121.464052,43.792862,"field  ph"
"4569",24391,0,2005,2005,1,-122.86306,45.84076,"field  ph"
"4570",24401,0,2005,2005,1,-123.172242,43.407381,"field  ph"
"4571",24409,1,2001,2002,12,-122.783508,42.440414,"field  ph"
"4572",24410,1,2001,2002,6,-122.507319,42.355833,"field  ph"
"4573",24411,0,2002,2002,8,-122.849844,42.681817,"field  ph"
"4574",24450,1,2001,2002,2,-122.683228,42.761358,"field  ph"
"4575",24451,1,2001,2002,35,-122.690306,42.655872,"field  ph"
"4576",24457,1,2001,2002,5,-122.753197,42.663548,"field  ph"
"4577",24488,5,2002,2007,4,-123.93222,44.60538,"field  ph"
"4578",24489,9,2002,2011,5,-123.93369,44.60559,"field  ph"
"4579",24490,2,2002,2004,2,-123.92893,44.60188,"field  ph"
"4580",24491,0,2002,2002,1,-123.9316,44.6049,"field  ph"
"4581",24492,9,2002,2011,5,-123.92233,44.60043,"field  ph"
"4582",24501,2,2001,2003,7,-121.53731,43.69052,"field  ph"
"4583",24503,1,2001,2002,2,-121.47607,43.70743,"field  ph"
"4584",24504,2,2001,2003,10,-121.47622,43.70785,"field  ph"
"4585",24505,2,2001,2003,10,-121.47728,43.70758,"field  ph"
"4586",24506,2,2001,2003,8,-121.51961,43.70975,"field  ph"
"4587",24508,0,2002,2002,2,-121.51908,43.71014,"field  ph"
"4588",24509,2,2001,2003,8,-121.51677,43.7125,"field  ph"
"4589",24510,2,2001,2003,8,-121.51719,43.71291,"field  ph"
"4590",24511,2,2001,2003,8,-121.516065,43.712903,"field  ph"
"4591",24512,3,2001,2004,9,-121.50083,43.71306,"field  ph"
"4592",24513,3,2001,2004,9,-121.50056,43.71333,"field  ph"
"4593",24517,2,2001,2003,10,-121.50023,43.74202,"field  ph"
"4594",24518,2,2001,2003,8,-121.50044,43.74362,"field  ph"
"4595",24519,2,2001,2003,10,-121.49929,43.74364,"field  ph"
"4596",24548,5,2005,2010,3,-121.13755,45.56747,"field  ph"
"4597",24561,0,2009,2009,1,-123.37976,43.18707,"field  ph"
"4598",24562,0,2009,2009,1,-123.37969,43.18703,"field  ph"
"4599",24576,1,2002,2003,8,-121.48088,43.83669,"field  ph"
"4600",24578,2,2001,2003,13,-121.494631,43.730308,"field  ph"
"4601",24580,2,2001,2003,17,-121.494496,43.730231,"field  ph"
"4602",24581,2,2001,2003,14,-121.494503,43.730204,"field  ph"
"4603",24582,2,2001,2003,12,-121.464119,43.792859,"field  ph"
"4604",24585,2,2001,2003,13,-121.463913,43.792493,"field  ph"
"4605",24586,2,2001,2003,18,-121.463982,43.793019,"field  ph"
"4606",24590,0,2009,2009,2,-123.16316,44.33209,"field  ph"
"4607",24592,7,2002,2009,3,-123.12846,44.3158,"field  ph"
"4608",24597,2,2001,2003,18,-121.459773,43.794534,"field  ph"
"4609",24598,2,2001,2003,12,-121.459472,43.794677,"field  ph"
"4610",24599,2,2001,2003,13,-121.465437,43.821942,"field  ph"
"4611",24600,2,2001,2003,19,-121.465284,43.821938,"field  ph"
"4612",24601,2,2001,2003,13,-121.465281,43.821642,"field  ph"
"4613",24604,4,2002,2006,2,-122.92536,44.61331,"field  ph"
"4614",24607,2,2001,2003,23,-121.521171,43.70068,"field  ph"
"4615",24608,2,2001,2003,17,-121.477183,43.707738,"field  ph"
"4616",24609,2,2001,2003,15,-121.478097,43.715172,"field  ph"
"4617",24610,1,2001,2002,4,-121.519353,43.709913,"field  ph"
"4618",24611,3,2001,2004,31,-121.516251,43.712803,"field  ph"
"4619",24612,2,2001,2003,19,-121.45929,43.830933,"field  ph"
"4620",24613,2,2001,2003,18,-121.499226,43.743467,"field  ph"
"4621",24614,2,2001,2003,22,-121.497529,43.702649,"field  ph"
"4622",24615,1,2002,2003,13,-121.461357,43.790607,"field  ph"
"4623",24616,2,2001,2003,8,-121.460158,43.830648,"field  ph"
"4624",24617,2,2001,2003,14,-121.459385,43.831098,"field  ph"
"4625",24618,2,2001,2003,16,-121.459356,43.831066,"field  ph"
"4626",24619,2,2001,2003,19,-121.459337,43.831026,"field  ph"
"4627",24621,2,2001,2003,10,-121.569532,43.639586,"field  ph"
"4628",24622,2,2001,2003,12,-121.569551,43.640423,"field  ph"
"4629",24623,2,2001,2003,11,-121.569551,43.64045,"field  ph"
"4630",24625,2,2001,2003,17,-121.568061,43.640232,"field  ph"
"4631",24627,2,2001,2003,16,-121.568106,43.640269,"field  ph"
"4632",24628,2,2001,2003,16,-121.568306,43.640127,"field  ph"
"4633",24630,1,2002,2003,6,-121.547567,43.702176,"field  ph"
"4634",24631,2,2001,2003,9,-121.54643,43.702207,"field  ph"
"4635",24632,2,2001,2003,9,-121.547207,43.701535,"field  ph"
"4636",24633,2,2002,2004,15,-121.547263,43.701555,"field  ph"
"4637",24634,3,2001,2004,24,-121.547058,43.701781,"field  ph"
"4638",24635,2,2001,2003,11,-121.522216,43.700471,"field  ph"
"4639",24636,2,2001,2003,10,-121.522209,43.701174,"field  ph"
"4640",24637,2,2001,2003,10,-121.52121,43.701268,"field  ph"
"4641",24639,2,2001,2003,17,-121.521416,43.700597,"field  ph"
"4642",24641,2,2001,2003,17,-121.521494,43.700592,"field  ph"
"4643",24642,2,2001,2003,15,-121.521424,43.700947,"field  ph"
"4644",24643,3,2001,2004,23,-121.519032,43.709907,"field  ph"
"4645",24644,2,2002,2004,20,-121.519575,43.709905,"field  ph"
"4646",24645,2,2002,2004,14,-121.516173,43.712769,"field  ph"
"4647",24646,3,2001,2004,20,-121.517581,43.712739,"field  ph"
"4648",24648,0,2001,2001,1,-121.460742,43.790434,"field  ph"
"4649",24649,0,2001,2001,2,-121.459396,43.831094,"field  ph"
"4650",24651,0,2009,2009,1,-123.21353,44.5791,"field  ph"
"4651",24655,2,2001,2003,17,-121.497325,43.702543,"field  ph"
"4652",24656,2,2001,2003,17,-121.49733,43.702518,"field  ph"
"4653",24657,2,2001,2003,30,-121.497359,43.702491,"field  ph"
"4654",24659,2,2001,2003,13,-121.476727,43.707493,"field  ph"
"4655",24661,2,2001,2003,8,-121.478107,43.714898,"field  ph"
"4656",24663,2,2001,2003,7,-121.478113,43.715387,"field  ph"
"4657",24664,2,2001,2003,13,-121.477723,43.714997,"field  ph"
"4658",24665,2,2001,2003,15,-121.495002,43.729247,"field  ph"
"4659",24666,2,2001,2003,15,-121.49539,43.729411,"field  ph"
"4660",24667,2,2001,2003,20,-121.495338,43.729463,"field  ph"
"4661",24668,2,2001,2003,11,-121.4598,43.794643,"field  ph"
"4662",24669,2,2001,2003,8,-121.477374,43.715312,"field  ph"
"4663",24670,2,2001,2003,8,-121.465205,43.821748,"field  ph"
"4664",24671,2,2001,2003,9,-121.465179,43.821325,"field  ph"
"4665",24672,2,2001,2003,9,-121.465463,43.821476,"field  ph"
"4666",24673,2,2001,2003,13,-121.460764,43.79042,"field  ph"
"4667",24674,2,2001,2003,14,-121.4608,43.790426,"field  ph"
"4668",24675,2,2001,2003,18,-121.460854,43.790442,"field  ph"
"4669",24676,10,2002,2012,4,-121.80452,42.17722,"field  ph"
"4670",24678,10,2002,2012,5,-121.80387,42.17511,"field  ph"
"4671",24679,10,2002,2012,4,-121.80475,42.1743,"field  ph"
"4672",24682,0,2001,2001,2,-121.497326,43.702575,"field  ph"
"4673",24683,2,2001,2003,14,-121.464178,43.824022,"field  ph"
"4674",24685,7,2002,2009,4,-123.1973,44.63145,"field  ph"
"4675",24690,2,2001,2003,14,-121.500523,43.742338,"field  ph"
"4676",24692,2,2001,2003,14,-121.500523,43.742372,"field  ph"
"4677",24696,0,2009,2009,2,-123.10714,44.54058,"field  ph"
"4678",24701,0,2009,2009,2,-123.10284,44.53886,"field  ph"
"4679",24712,0,2009,2009,1,-122.96089,44.6669,"field  ph"
"4680",24728,0,2002,2002,1,-122.95059,44.7079,"field  ph"
"4681",24732,0,2009,2009,1,-122.91704,44.65045,"field  ph"
"4682",24736,0,2009,2009,1,-123.18527,44.51069,"field  ph"
"4683",24738,7,2002,2009,3,-123.2099,44.40309,"field  ph"
"4684",24739,0,2009,2009,1,-123.20382,44.4415,"field  ph"
"4685",10332,0,2001,2001,1,-122.7475,45.577944,"dissolved  sodium"
"4686",10342,0,2001,2001,1,-122.942361,45.267639,"dissolved  sodium"
"4687",10350,0,2001,2001,1,-123.105778,44.639722,"dissolved  sodium"
"4688",10352,0,2001,2001,2,-123.255417,44.565528,"dissolved  sodium"
"4689",10355,0,2001,2001,1,-123.173667,44.267167,"dissolved  sodium"
"4690",10363,1,2006,2007,26,-123.071583,45.223639,"dissolved  sodium"
"4691",10407,0,2006,2006,3,-116.972222,44.05675,"dissolved  sodium"
"4692",10408,0,2006,2006,4,-117.141361,44.000222,"dissolved  sodium"
"4693",10535,1,2008,2009,8,-124.352306,42.277056,"dissolved  sodium"
"4694",10555,0,2001,2001,1,-123.041528,44.946111,"dissolved  sodium"
"4695",10596,0,2007,2007,5,-124.192528,43.173778,"dissolved  sodium"
"4696",10611,0,2001,2001,1,-122.669889,45.513306,"dissolved  sodium"
"4697",10616,0,2001,2001,1,-122.738861,45.645639,"dissolved  sodium"
"4698",10674,0,2001,2001,1,-122.375444,45.5385,"dissolved  sodium"
"4699",10727,0,2006,2006,3,-117.363972,43.939472,"dissolved  sodium"
"4700",10728,0,2006,2006,3,-117.229167,43.988056,"dissolved  sodium"
"4701",10801,0,2001,2001,1,-122.709083,45.563806,"dissolved  sodium"
"4702",10896,0,2007,2007,1,-122.7804,45.1477,"dissolved  sodium"
"4703",10899,0,2007,2007,1,-122.8225,45.1004,"dissolved  sodium"
"4704",10929,1,2006,2007,19,-123.17417,45.25194,"dissolved  sodium"
"4705",10948,1,2006,2007,17,-123.206917,45.168667,"dissolved  sodium"
"4706",10996,0,2006,2006,5,-123.459528,43.366361,"dissolved  sodium"
"4707",11044,0,2006,2006,3,-117.603722,43.854389,"dissolved  sodium"
"4708",11047,0,2006,2006,3,-118.331778,43.783778,"dissolved  sodium"
"4709",11201,0,2001,2001,1,-122.753056,45.6105,"dissolved  sodium"
"4710",11480,0,2006,2006,3,-117.507583,43.910333,"dissolved  sodium"
"4711",11493,1,2008,2009,8,-124.395556,42.272222,"dissolved  sodium"
"4712",11505,1,2006,2007,23,-123.199583,45.152722,"dissolved  sodium"
"4713",11698,0,2007,2007,5,-124.189139,43.124528,"dissolved  sodium"
"4714",11704,0,2007,2007,5,-124.222139,43.177139,"dissolved  sodium"
"4715",11724,0,2007,2007,2,-124.146611,43.06975,"dissolved  sodium"
"4716",11725,0,2007,2007,2,-124.193667,43.173583,"dissolved  sodium"
"4717",11778,0,2005,2005,2,-120.793333,44.109722,"dissolved  sodium"
"4718",11884,1,2006,2007,25,-124.208111,43.356306,"dissolved  sodium"
"4719",12212,0,2005,2005,7,-120.716583,44.299083,"dissolved  sodium"
"4720",12590,4,2004,2008,18,-124.451694,42.916278,"dissolved  sodium"
"4721",12604,0,2009,2009,1,-124.179806,43.57175,"dissolved  sodium"
"4722",12605,0,2009,2009,1,-124.180111,43.571306,"dissolved  sodium"
"4723",12796,0,2006,2006,4,-123.240833,43.443306,"dissolved  sodium"
"4724",12800,0,2006,2006,4,-123.3075,43.421111,"dissolved  sodium"
"4725",12803,0,2006,2006,5,-123.163861,43.409,"dissolved  sodium"
"4726",13216,0,2009,2009,3,-124.007806,43.490444,"dissolved  sodium"
"4727",13386,0,2006,2006,4,-124.208889,43.364167,"dissolved  sodium"
"4728",13388,1,2006,2007,27,-124.192778,43.356667,"dissolved  sodium"
"4729",13389,1,2006,2007,27,-124.206944,43.301389,"dissolved  sodium"
"4730",13540,0,2006,2006,6,-124.192222,43.335556,"dissolved  sodium"
"4731",13568,0,2009,2009,3,-124.023333,43.433056,"dissolved  sodium"
"4732",13569,0,2009,2009,3,-124.030556,43.425,"dissolved  sodium"
"4733",13570,0,2009,2009,3,-124.058583,43.405667,"dissolved  sodium"
"4734",13583,1,2006,2007,17,-124.204083,43.325778,"dissolved  sodium"
"4735",13781,0,2002,2002,16,-122.346389,42.378056,"dissolved  sodium"
"4736",13782,1,2004,2005,11,-124.505139,42.896361,"dissolved  sodium"
"4737",13807,0,2004,2004,4,-121.774294,43.925019,"dissolved  sodium"
"4738",13945,0,2002,2002,19,-122.154333,43.170278,"dissolved  sodium"
"4739",14018,0,2008,2008,1,-124.118972,43.548111,"dissolved  sodium"
"4740",14182,5,2002,2007,2,-124.0585,44.6979,"dissolved  sodium"
"4741",14183,0,2002,2002,1,-124.0595,44.697,"dissolved  sodium"
"4742",14185,0,2002,2002,1,-124.0593,44.6967,"dissolved  sodium"
"4743",14187,5,2002,2007,3,-124.0593,44.6963,"dissolved  sodium"
"4744",14192,0,2002,2002,1,-124.058889,44.696111,"dissolved  sodium"
"4745",14225,0,2011,2011,1,-122.736944,42.2625,"dissolved  sodium"
"4746",14226,0,2011,2011,1,-122.732778,42.268889,"dissolved  sodium"
"4747",14228,0,2011,2011,1,-122.735,42.261944,"dissolved  sodium"
"4748",14240,8,2002,2010,3,-117.778611,44.708056,"dissolved  sodium"
"4749",14241,8,2002,2010,6,-117.783056,44.706111,"dissolved  sodium"
"4750",14242,8,2002,2010,5,-117.784167,44.706111,"dissolved  sodium"
"4751",14243,8,2002,2010,5,-117.784167,44.704722,"dissolved  sodium"
"4752",14244,5,2005,2010,2,-124.355833,43.202778,"dissolved  sodium"
"4753",14245,5,2005,2010,2,-124.350278,43.208056,"dissolved  sodium"
"4754",14246,5,2005,2010,2,-124.350556,43.207778,"dissolved  sodium"
"4755",14247,5,2005,2010,2,-124.356111,43.2025,"dissolved  sodium"
"4756",14248,5,2005,2010,2,-124.350833,43.208889,"dissolved  sodium"
"4757",14249,5,2005,2010,4,-124.351944,43.206389,"dissolved  sodium"
"4758",14254,0,2005,2005,1,-122.878889,45.851389,"dissolved  sodium"
"4759",14255,0,2005,2005,1,-122.886111,45.850833,"dissolved  sodium"
"4760",14256,0,2005,2005,1,-122.88,45.850556,"dissolved  sodium"
"4761",14257,0,2005,2005,1,-122.881389,45.849722,"dissolved  sodium"
"4762",14258,0,2005,2005,1,-122.879167,45.85,"dissolved  sodium"
"4763",14259,0,2005,2005,2,-122.878889,45.849722,"dissolved  sodium"
"4764",14260,0,2005,2005,1,-122.878333,45.849444,"dissolved  sodium"
"4765",14263,0,2005,2005,1,-122.881667,45.85,"dissolved  sodium"
"4766",14266,0,2002,2002,1,-124.316111,43.205278,"dissolved  sodium"
"4767",14267,4,2005,2009,4,-124.316944,43.208611,"dissolved  sodium"
"4768",14268,0,2009,2009,1,-124.316389,43.210278,"dissolved  sodium"
"4769",14314,0,2002,2002,1,-123.081111,44.922778,"dissolved  sodium"
"4770",14320,0,2002,2002,1,-123.078611,44.925833,"dissolved  sodium"
"4771",14321,0,2002,2002,1,-123.078611,44.925833,"dissolved  sodium"
"4772",14322,0,2002,2002,1,-123.078611,44.925833,"dissolved  sodium"
"4773",14334,0,2002,2002,2,-123.091944,44.920833,"dissolved  sodium"
"4774",14393,4,2002,2006,3,-123.94616,46.16115,"dissolved  sodium"
"4775",14421,0,2001,2001,1,-122.948333,44.023056,"dissolved  sodium"
"4776",14422,0,2001,2001,1,-122.945556,44.024167,"dissolved  sodium"
"4777",14423,0,2001,2001,1,-122.945556,44.024167,"dissolved  sodium"
"4778",14425,0,2009,2009,1,-123.232778,44.696667,"dissolved  sodium"
"4779",14429,0,2006,2006,1,-123.236389,44.696667,"dissolved  sodium"
"4780",14434,0,2009,2009,1,-123.244444,44.697778,"dissolved  sodium"
"4781",14435,0,2006,2006,2,-123.246111,44.699444,"dissolved  sodium"
"4782",14444,0,2006,2006,1,-123.239167,44.697222,"dissolved  sodium"
"4783",14445,0,2009,2009,1,-123.239167,44.697222,"dissolved  sodium"
"4784",14459,0,2006,2006,1,-123.225278,44.699722,"dissolved  sodium"
"4785",14460,0,2009,2009,2,-123.227778,44.698611,"dissolved  sodium"
"4786",14463,7,2001,2008,6,-120.201528,45.7175,"dissolved  sodium"
"4787",14475,0,2001,2001,2,-120.252111,45.622222,"dissolved  sodium"
"4788",14476,2,2003,2005,2,-120.255333,45.629333,"dissolved  sodium"
"4789",14481,0,2001,2001,4,-120.257,45.619917,"dissolved  sodium"
"4790",14482,0,2001,2001,2,-120.256944,45.619917,"dissolved  sodium"
"4791",14488,2,2001,2003,3,-120.251389,45.622778,"dissolved  sodium"
"4792",14500,2,2003,2005,2,-120.253528,45.622333,"dissolved  sodium"
"4793",14509,7,2001,2008,8,-120.287417,45.603194,"dissolved  sodium"
"4794",14510,7,2001,2008,9,-120.295528,45.574944,"dissolved  sodium"
"4795",14511,7,2001,2008,6,-120.299917,45.572111,"dissolved  sodium"
"4796",14732,0,2003,2003,1,-122.768056,42.376667,"dissolved  sodium"
"4797",14734,3,2003,2006,2,-122.774444,42.376111,"dissolved  sodium"
"4798",14741,6,2003,2009,3,-122.770833,42.385556,"dissolved  sodium"
"4799",14742,0,2009,2009,1,-122.771667,42.375833,"dissolved  sodium"
"4800",14743,0,2003,2003,1,-122.773333,42.386667,"dissolved  sodium"
"4801",14754,6,2005,2011,2,-122.588889,45.568056,"dissolved  sodium"
"4802",14776,0,2003,2003,1,-122.447361,45.55875,"dissolved  sodium"
"4803",14804,0,2004,2004,1,-122.806667,45.623056,"dissolved  sodium"
"4804",14805,0,2004,2004,1,-122.81,45.624722,"dissolved  sodium"
"4805",14806,0,2004,2004,1,-122.811389,45.625833,"dissolved  sodium"
"4806",14807,0,2004,2004,1,-122.806389,45.625833,"dissolved  sodium"
"4807",14809,6,2002,2008,3,-119.581389,45.686389,"dissolved  sodium"
"4808",14810,6,2002,2008,4,-119.586111,45.683611,"dissolved  sodium"
"4809",14811,6,2002,2008,3,-119.580833,45.689722,"dissolved  sodium"
"4810",14812,6,2002,2008,4,-119.583333,45.690556,"dissolved  sodium"
"4811",14813,6,2002,2008,3,-119.601111,45.686389,"dissolved  sodium"
"4812",14814,6,2002,2008,4,-119.591389,45.699722,"dissolved  sodium"
"4813",14822,5,2007,2012,2,-124.116111,43.984167,"dissolved  sodium"
"4814",14823,5,2007,2012,2,-124.118889,43.989167,"dissolved  sodium"
"4815",14824,5,2007,2012,4,-124.113889,43.988333,"dissolved  sodium"
"4816",14830,6,2004,2010,2,-120.21725,45.657917,"dissolved  sodium"
"4817",14831,6,2004,2010,3,-120.223333,45.646778,"dissolved  sodium"
"4818",14832,6,2004,2010,5,-120.204972,45.655528,"dissolved  sodium"
"4819",14833,6,2004,2010,3,-120.209722,45.661611,"dissolved  sodium"
"4820",14857,0,2011,2011,1,-123.271333,42.427333,"dissolved  sodium"
"4821",14931,3,2002,2005,2,-122.976667,45.498056,"dissolved  sodium"
"4822",14934,3,2002,2005,3,-122.969444,45.495,"dissolved  sodium"
"4823",14939,3,2002,2005,3,-122.980278,45.494167,"dissolved  sodium"
"4824",14940,8,2002,2010,4,-122.979444,45.495278,"dissolved  sodium"
"4825",14941,0,2002,2002,1,-122.978889,45.497222,"dissolved  sodium"
"4826",15009,7,2002,2009,3,-124.292222,43.316667,"dissolved  sodium"
"4827",15011,0,2006,2006,1,-124.298056,43.321389,"dissolved  sodium"
"4828",15012,7,2002,2009,3,-124.298056,43.317778,"dissolved  sodium"
"4829",15013,7,2002,2009,2,-124.295833,43.319167,"dissolved  sodium"
"4830",15015,7,2002,2009,3,-124.289167,43.318333,"dissolved  sodium"
"4831",15016,0,2002,2002,1,-124.297778,43.319444,"dissolved  sodium"
"4832",15020,0,2006,2006,1,-124.291111,43.316667,"dissolved  sodium"
"4833",15039,0,2003,2003,1,-123.623611,42.214722,"dissolved  sodium"
"4834",15116,9,2002,2011,4,-121.250278,44.013056,"dissolved  sodium"
"4835",15118,0,2002,2002,1,-121.253056,44.008056,"dissolved  sodium"
"4836",15119,6,2002,2008,3,-122.8725,45.409722,"dissolved  sodium"
"4837",15120,8,2002,2010,4,-122.871944,45.407222,"dissolved  sodium"
"4838",15121,8,2002,2010,4,-122.870833,45.408889,"dissolved  sodium"
"4839",15122,8,2002,2010,4,-122.870278,45.408333,"dissolved  sodium"
"4840",15123,8,2002,2010,5,-122.872778,45.408333,"dissolved  sodium"
"4841",15124,8,2002,2010,4,-122.872778,45.408611,"dissolved  sodium"
"4842",15125,8,2002,2010,5,-122.869167,45.408333,"dissolved  sodium"
"4843",15126,8,2002,2010,5,-122.870833,45.408333,"dissolved  sodium"
"4844",15144,9,2002,2011,10,-117.229167,43.988056,"dissolved  sodium"
"4845",15151,9,2002,2011,14,-117.035,44.011,"dissolved  sodium"
"4846",15155,9,2002,2011,8,-116.955,44.02,"dissolved  sodium"
"4847",15169,8,2002,2010,8,-117.01,44.026,"dissolved  sodium"
"4848",15174,8,2002,2010,10,-117.023,44.013,"dissolved  sodium"
"4849",15180,9,2002,2011,10,-117.011,43.988,"dissolved  sodium"
"4850",15183,9,2002,2011,10,-116.99,43.962,"dissolved  sodium"
"4851",15186,9,2002,2011,11,-117.023,43.997,"dissolved  sodium"
"4852",15201,8,2002,2010,8,-116.995,44.199,"dissolved  sodium"
"4853",15203,9,2002,2011,10,-116.963,44.096,"dissolved  sodium"
"4854",15216,9,2002,2011,10,-116.985,43.895,"dissolved  sodium"
"4855",15217,9,2002,2011,11,-116.994,43.923,"dissolved  sodium"
"4856",15221,9,2002,2011,10,-116.993,43.953,"dissolved  sodium"
"4857",15229,9,2002,2011,10,-117.078,44.01,"dissolved  sodium"
"4858",15233,9,2002,2011,9,-117.268861,43.967306,"dissolved  sodium"
"4859",15234,9,2002,2011,9,-117.018,44.019,"dissolved  sodium"
"4860",15236,9,2002,2011,15,-117.004,43.931,"dissolved  sodium"
"4861",15244,9,2002,2011,11,-117.260194,44.026639,"dissolved  sodium"
"4862",15249,9,2002,2011,11,-117.08,43.997,"dissolved  sodium"
"4863",15253,9,2002,2011,11,-117.185,44.003,"dissolved  sodium"
"4864",15254,9,2002,2011,10,-117.237,43.986,"dissolved  sodium"
"4865",15257,9,2002,2011,12,-117.228,43.994,"dissolved  sodium"
"4866",15264,9,2002,2011,12,-117.049944,43.995833,"dissolved  sodium"
"4867",15275,8,2002,2010,8,-116.99,44.062,"dissolved  sodium"
"4868",15280,7,2002,2009,9,-116.989,44.061,"dissolved  sodium"
"4869",15284,9,2002,2011,12,-117.2925,43.909722,"dissolved  sodium"
"4870",15289,9,2002,2011,10,-116.995,44.198333,"dissolved  sodium"
"4871",15291,9,2002,2011,14,-117.175,44.136111,"dissolved  sodium"
"4872",15294,9,2002,2011,10,-117.248333,43.966667,"dissolved  sodium"
"4873",15302,9,2002,2011,9,-117.061111,43.992222,"dissolved  sodium"
"4874",15327,9,2002,2011,9,-117.035278,44.010833,"dissolved  sodium"
"4875",15328,8,2003,2011,11,-117.004167,44.230556,"dissolved  sodium"
"4876",15329,9,2002,2011,11,-117.004194,43.894444,"dissolved  sodium"
"4877",15330,6,2005,2011,2,-122.699167,45.591667,"dissolved  sodium"
"4878",15331,6,2005,2011,3,-122.700833,45.591944,"dissolved  sodium"
"4879",15361,4,2007,2011,3,-123.396944,42.501389,"dissolved  sodium"
"4880",15363,4,2007,2011,2,-123.397222,42.501944,"dissolved  sodium"
"4881",15387,4,2007,2011,2,-123.398056,42.504722,"dissolved  sodium"
"4882",15446,0,2008,2008,1,-122.580833,45.5625,"dissolved  sodium"
"4883",15450,6,2005,2011,2,-122.583889,45.563056,"dissolved  sodium"
"4884",15451,3,2005,2008,3,-122.587278,45.566833,"dissolved  sodium"
"4885",15452,6,2005,2011,5,-122.585806,45.566556,"dissolved  sodium"
"4886",15453,6,2005,2011,3,-122.5845,45.566167,"dissolved  sodium"
"4887",15459,3,2005,2008,4,-122.973889,45.2825,"dissolved  sodium"
"4888",15499,0,2009,2009,2,-122.387778,45.525556,"dissolved  sodium"
"4889",15500,0,2009,2009,1,-122.387778,45.523056,"dissolved  sodium"
"4890",15508,0,2002,2002,2,-123.105556,44.601944,"dissolved  sodium"
"4891",15509,0,2002,2002,1,-123.106389,44.601667,"dissolved  sodium"
"4892",15510,0,2002,2002,1,-123.105,44.603056,"dissolved  sodium"
"4893",15511,0,2002,2002,1,-123.106111,44.602778,"dissolved  sodium"
"4894",15517,9,2002,2011,10,-117.155,43.796,"dissolved  sodium"
"4895",15525,6,2002,2008,2,-117.055944,43.796,"dissolved  sodium"
"4896",15538,9,2002,2011,12,-117.24425,43.643056,"dissolved  sodium"
"4897",15540,9,2002,2011,10,-117.111111,43.780556,"dissolved  sodium"
"4898",15541,9,2002,2011,10,-117.145833,43.786111,"dissolved  sodium"
"4899",15542,7,2001,2008,2,-124.5075,42.771944,"dissolved  sodium"
"4900",15543,0,2008,2008,2,-124.508889,42.769444,"dissolved  sodium"
"4901",15546,7,2001,2008,3,-124.505,42.768611,"dissolved  sodium"
"4902",15548,0,2008,2008,1,-124.508056,42.767778,"dissolved  sodium"
"4903",15569,0,2008,2008,1,-124.071111,43.690833,"dissolved  sodium"
"4904",15574,0,2008,2008,1,-124.068056,43.688333,"dissolved  sodium"
"4905",15577,0,2008,2008,1,-124.07,43.688333,"dissolved  sodium"
"4906",15578,0,2008,2008,1,-124.071389,43.690556,"dissolved  sodium"
"4907",15581,0,2008,2008,2,-124.067778,43.688889,"dissolved  sodium"
"4908",15611,6,2002,2008,2,-123.246944,45.157778,"dissolved  sodium"
"4909",15612,6,2002,2008,2,-123.246944,45.158056,"dissolved  sodium"
"4910",15615,6,2002,2008,2,-123.242222,45.160556,"dissolved  sodium"
"4911",15617,0,2008,2008,1,-123.25,45.158056,"dissolved  sodium"
"4912",15618,0,2008,2008,1,-123.249722,45.157778,"dissolved  sodium"
"4913",15619,0,2008,2008,1,-123.243333,45.159444,"dissolved  sodium"
"4914",15663,0,2011,2011,1,-123.419444,42.439722,"dissolved  sodium"
"4915",15669,0,2011,2011,1,-123.271111,42.425278,"dissolved  sodium"
"4916",15682,0,2011,2011,1,-122.830833,42.425278,"dissolved  sodium"
"4917",15690,0,2011,2011,1,-122.9325,42.359444,"dissolved  sodium"
"4918",15697,0,2006,2006,1,-123.3772,43.1847,"dissolved  sodium"
"4919",15704,3,2006,2009,2,-123.378611,43.185833,"dissolved  sodium"
"4920",15705,3,2006,2009,3,-123.378611,43.185833,"dissolved  sodium"
"4921",15719,0,2006,2006,1,-123.381944,43.191389,"dissolved  sodium"
"4922",15721,0,2006,2006,1,-123.365278,43.187222,"dissolved  sodium"
"4923",15723,0,2006,2006,1,-123.376111,43.184722,"dissolved  sodium"
"4924",15724,0,2009,2009,1,-123.375833,43.184444,"dissolved  sodium"
"4925",15725,3,2006,2009,3,-123.377778,43.184722,"dissolved  sodium"
"4926",15727,0,2009,2009,1,-123.380278,43.186389,"dissolved  sodium"
"4927",15755,0,2002,2002,2,-122.591167,45.369,"dissolved  sodium"
"4928",15785,3,2006,2009,2,-123.012222,43.954444,"dissolved  sodium"
"4929",15789,3,2006,2009,3,-122.997722,43.957,"dissolved  sodium"
"4930",15791,3,2006,2009,2,-122.993472,43.956111,"dissolved  sodium"
"4931",15798,3,2006,2009,3,-122.991639,43.955861,"dissolved  sodium"
"4932",15834,0,2002,2002,1,-121.445,43.782778,"dissolved  sodium"
"4933",15835,0,2002,2002,1,-121.446389,43.782778,"dissolved  sodium"
"4934",15837,0,2002,2002,1,-121.444861,43.782778,"dissolved  sodium"
"4935",15838,0,2002,2002,2,-121.444722,43.783056,"dissolved  sodium"
"4936",15866,6,2003,2009,2,-122.949444,42.305833,"dissolved  sodium"
"4937",15868,6,2003,2009,2,-122.954722,42.303889,"dissolved  sodium"
"4938",15869,6,2003,2009,2,-122.953889,42.304444,"dissolved  sodium"
"4939",15870,6,2003,2009,4,-122.954167,42.303611,"dissolved  sodium"
"4940",15913,0,2011,2011,1,-122.759167,45.620833,"dissolved  sodium"
"4941",15914,0,2011,2011,1,-122.757778,45.618056,"dissolved  sodium"
"4942",15916,0,2011,2011,1,-122.761389,45.615833,"dissolved  sodium"
"4943",15917,0,2008,2008,2,-122.761389,45.615833,"dissolved  sodium"
"4944",15924,0,2011,2011,1,-122.745,45.613056,"dissolved  sodium"
"4945",15935,0,2002,2002,1,-122.752333,45.618806,"dissolved  sodium"
"4946",15936,6,2002,2008,2,-122.752333,45.618806,"dissolved  sodium"
"4947",15937,0,2002,2002,1,-122.744167,45.615444,"dissolved  sodium"
"4948",15938,6,2002,2008,2,-122.744167,45.615444,"dissolved  sodium"
"4949",15940,9,2002,2011,2,-122.753889,45.618889,"dissolved  sodium"
"4950",15941,6,2002,2008,3,-122.745306,45.605694,"dissolved  sodium"
"4951",15942,0,2002,2002,1,-122.745306,45.605694,"dissolved  sodium"
"4952",15947,3,2008,2011,2,-122.758611,45.618056,"dissolved  sodium"
"4953",15949,0,2002,2002,1,-122.743889,45.614306,"dissolved  sodium"
"4954",15968,0,2005,2005,1,-123.839722,45.416389,"dissolved  sodium"
"4955",15970,0,2005,2005,1,-123.837222,45.416111,"dissolved  sodium"
"4956",15971,0,2005,2005,1,-123.836111,45.417222,"dissolved  sodium"
"4957",15972,0,2005,2005,1,-123.84,45.408889,"dissolved  sodium"
"4958",15978,0,2005,2005,1,-123.836667,45.416667,"dissolved  sodium"
"4959",15979,0,2005,2005,1,-123.836667,45.416667,"dissolved  sodium"
"4960",15985,0,2005,2005,1,-123.852222,45.415556,"dissolved  sodium"
"4961",15986,0,2005,2005,2,-123.85225,45.415556,"dissolved  sodium"
"4962",15987,0,2005,2005,1,-123.851944,45.411667,"dissolved  sodium"
"4963",15990,0,2005,2005,1,-123.847222,45.416389,"dissolved  sodium"
"4964",16018,5,2001,2006,13,-119.6881,45.8296,"dissolved  sodium"
"4965",16019,5,2001,2006,9,-119.7083,45.8194,"dissolved  sodium"
"4966",16023,5,2001,2006,16,-119.5315,45.8973,"dissolved  sodium"
"4967",16024,5,2001,2006,13,-119.5395,45.9023,"dissolved  sodium"
"4968",16028,5,2001,2006,13,-119.3282,45.9196,"dissolved  sodium"
"4969",16029,1,2001,2002,4,-119.2732,45.8651,"dissolved  sodium"
"4970",16036,5,2001,2006,17,-119.221,45.8344,"dissolved  sodium"
"4971",16037,5,2001,2006,13,-119.2252,45.7856,"dissolved  sodium"
"4972",16038,5,2001,2006,15,-119.2168,45.7865,"dissolved  sodium"
"4973",16046,5,2001,2006,15,-119.1537,45.8248,"dissolved  sodium"
"4974",16048,3,2001,2004,10,-119.3098,45.7946,"dissolved  sodium"
"4975",16056,1,2001,2002,3,-119.1711,45.9106,"dissolved  sodium"
"4976",16074,5,2001,2006,15,-119.3209,45.8132,"dissolved  sodium"
"4977",16075,4,2001,2005,14,-119.6429,45.8288,"dissolved  sodium"
"4978",16078,1,2001,2002,4,NA,NA,"dissolved  sodium"
"4979",16084,5,2001,2006,14,-119.353,45.8291,"dissolved  sodium"
"4980",16086,5,2001,2006,13,-119.3817,45.9132,"dissolved  sodium"
"4981",16093,5,2001,2006,12,-119.4396,45.9055,"dissolved  sodium"
"4982",16096,5,2001,2006,15,-119.1896,45.8637,"dissolved  sodium"
"4983",16099,5,2001,2006,15,-119.2194,45.8865,"dissolved  sodium"
"4984",16100,5,2001,2006,16,-119.1641,45.8467,"dissolved  sodium"
"4985",16102,5,2001,2006,13,-119.3884,45.7707,"dissolved  sodium"
"4986",16106,5,2001,2006,14,-119.2115,45.8647,"dissolved  sodium"
"4987",16109,5,2001,2006,17,-119.3151,45.8232,"dissolved  sodium"
"4988",16112,4,2001,2005,13,-119.3268,45.7903,"dissolved  sodium"
"4989",16123,5,2001,2006,13,-119.4351,45.7736,"dissolved  sodium"
"4990",16134,5,2001,2006,12,-119.5065,45.8863,"dissolved  sodium"
"4991",16146,5,2001,2006,16,-119.2396,45.8358,"dissolved  sodium"
"4992",16150,5,2001,2006,13,-119.5597,45.8658,"dissolved  sodium"
"4993",16154,4,2002,2006,11,-119.5067,45.8988,"dissolved  sodium"
"4994",16158,5,2001,2006,13,-119.4756,45.8065,"dissolved  sodium"
"4995",16170,5,2001,2006,13,-119.5102,45.8747,"dissolved  sodium"
"4996",16175,5,2001,2006,14,-119.343,45.7476,"dissolved  sodium"
"4997",16177,5,2001,2006,16,-119.3733,45.6978,"dissolved  sodium"
"4998",16180,5,2001,2006,15,-119.1966,45.7317,"dissolved  sodium"
"4999",16181,5,2001,2006,17,-119.2105,45.7586,"dissolved  sodium"
"5000",16188,5,2001,2006,16,-119.3728,45.8463,"dissolved  sodium"
"5001",16191,5,2001,2006,13,-119.6539,45.8509,"dissolved  sodium"
"5002",16272,5,2003,2008,2,-124.0715,44.3995,"dissolved  sodium"
"5003",16273,5,2003,2008,2,-124.0711,44.4013,"dissolved  sodium"
"5004",16275,5,2003,2008,3,-124.0711,44.3999,"dissolved  sodium"
"5005",16276,5,2003,2008,2,-124.0709,44.3999,"dissolved  sodium"
"5006",16278,5,2003,2008,2,-124.071,44.3998,"dissolved  sodium"
"5007",16280,5,2003,2008,3,-124.0686,44.4024,"dissolved  sodium"
"5008",16545,0,2002,2002,1,-123.245,44.25249,"dissolved  sodium"
"5009",16553,0,2002,2002,1,-123.18777,44.207779,"dissolved  sodium"
"5010",16677,0,2001,2001,1,-122.856389,45.174167,"dissolved  sodium"
"5011",16696,0,2001,2001,1,-122.859167,45.178611,"dissolved  sodium"
"5012",16697,7,2003,2010,4,-122.855556,45.178056,"dissolved  sodium"
"5013",16699,0,2001,2001,1,-122.859083,45.173389,"dissolved  sodium"
"5014",16701,9,2001,2010,5,-122.860556,45.179444,"dissolved  sodium"
"5015",16705,0,2010,2010,1,-122.856389,45.180833,"dissolved  sodium"
"5016",16708,0,2001,2001,1,-122.858889,45.174444,"dissolved  sodium"
"5017",16709,0,2001,2001,1,-122.858056,45.173333,"dissolved  sodium"
"5018",16718,0,2011,2011,2,-122.7325,42.263611,"dissolved  sodium"
"5019",16719,0,2011,2011,1,-122.736389,42.262778,"dissolved  sodium"
"5020",16721,0,2011,2011,1,-122.736111,42.261389,"dissolved  sodium"
"5021",16727,7,2002,2009,4,-124.318333,43.209167,"dissolved  sodium"
"5022",16732,3,2003,2006,2,-123.112778,44.098333,"dissolved  sodium"
"5023",16733,3,2003,2006,2,-123.106667,44.1075,"dissolved  sodium"
"5024",16734,3,2003,2006,2,-123.106111,44.107778,"dissolved  sodium"
"5025",16737,3,2003,2006,3,-123.108611,44.104167,"dissolved  sodium"
"5026",16738,3,2003,2006,3,-123.111111,44.100556,"dissolved  sodium"
"5027",16739,3,2006,2009,2,-122.771111,42.383333,"dissolved  sodium"
"5028",16740,3,2003,2006,2,-122.771389,42.383611,"dissolved  sodium"
"5029",16741,0,2006,2006,1,-122.772222,42.383333,"dissolved  sodium"
"5030",16742,0,2007,2007,1,-123.3382,43.3371,"dissolved  sodium"
"5031",16743,0,2007,2007,1,-123.337778,43.335833,"dissolved  sodium"
"5032",16754,7,2002,2009,4,-124.297222,43.318333,"dissolved  sodium"
"5033",16756,0,2002,2002,1,-124.298333,43.318889,"dissolved  sodium"
"5034",16757,0,2003,2003,2,-123.624722,42.213611,"dissolved  sodium"
"5035",16758,0,2003,2003,1,-123.625,42.215556,"dissolved  sodium"
"5036",16759,9,2002,2011,6,-121.747778,42.236111,"dissolved  sodium"
"5037",16760,9,2002,2011,6,-121.747778,42.233056,"dissolved  sodium"
"5038",16761,9,2002,2011,6,-121.751667,42.2325,"dissolved  sodium"
"5039",16762,9,2002,2011,7,-121.754722,42.232222,"dissolved  sodium"
"5040",16772,6,2003,2009,2,-122.952778,42.305556,"dissolved  sodium"
"5041",20422,6,2002,2008,3,-119.308333,45.886111,"dissolved  sodium"
"5042",20423,6,2002,2008,6,-119.305278,45.886111,"dissolved  sodium"
"5043",20424,6,2002,2008,3,-119.309722,45.89,"dissolved  sodium"
"5044",22667,0,2002,2002,1,-124.243419,43.436939,"dissolved  sodium"
"5045",22668,0,2002,2002,1,-124.238749,43.43694,"dissolved  sodium"
"5046",22669,0,2002,2002,1,-124.244882,43.436594,"dissolved  sodium"
"5047",22670,0,2002,2002,1,-124.243561,43.436594,"dissolved  sodium"
"5048",22671,0,2002,2002,1,-124.240966,43.436422,"dissolved  sodium"
"5049",22672,4,2002,2006,2,-124.241013,43.436491,"dissolved  sodium"
"5050",22673,0,2002,2002,1,-124.24587,43.434834,"dissolved  sodium"
"5051",22674,4,2002,2006,2,-124.244879,43.434282,"dissolved  sodium"
"5052",22675,4,2002,2006,4,-124.243888,43.434351,"dissolved  sodium"
"5053",22676,0,2004,2004,1,-123.426725,43.103019,"dissolved  sodium"
"5054",22677,0,2004,2004,1,-123.426539,43.100265,"dissolved  sodium"
"5055",22678,0,2004,2004,1,-123.426539,43.098648,"dissolved  sodium"
"5056",22679,0,2004,2004,1,-123.426304,43.099508,"dissolved  sodium"
"5057",22680,0,2004,2004,1,-123.426256,43.102881,"dissolved  sodium"
"5058",22681,0,2005,2005,1,-120.254125,45.621565,"dissolved  sodium"
"5059",22683,0,2002,2002,1,-122.744444,45.612222,"dissolved  sodium"
"5060",22684,5,2005,2010,3,-121.136719,45.560133,"dissolved  sodium"
"5061",22685,5,2005,2010,3,-121.138153,45.563756,"dissolved  sodium"
"5062",22687,2,2005,2007,2,-121.130381,45.561053,"dissolved  sodium"
"5063",22689,2,2005,2007,3,-121.141683,45.561742,"dissolved  sodium"
"5064",22691,0,2010,2010,2,-121.141272,45.565861,"dissolved  sodium"
"5065",22692,6,2005,2011,2,-122.699583,45.593611,"dissolved  sodium"
"5066",22696,6,2006,2012,3,-118.475833,45.9575,"dissolved  sodium"
"5067",22697,6,2006,2012,4,-118.480833,45.961667,"dissolved  sodium"
"5068",22698,6,2006,2012,5,-118.483333,45.958056,"dissolved  sodium"
"5069",22699,4,2002,2006,2,-121.251389,44.010556,"dissolved  sodium"
"5070",22700,9,2002,2011,2,-121.258889,44.010278,"dissolved  sodium"
"5071",22701,5,2006,2011,4,-121.446111,43.782778,"dissolved  sodium"
"5072",22702,5,2006,2011,4,-121.445,43.781667,"dissolved  sodium"
"5073",22705,5,2006,2011,3,-121.444722,43.782222,"dissolved  sodium"
"5074",22715,0,2002,2002,1,-122.995,44.900278,"dissolved  sodium"
"5075",22716,7,2002,2009,4,-122.998056,44.901389,"dissolved  sodium"
"5076",22719,7,2002,2009,4,-122.993889,44.897222,"dissolved  sodium"
"5077",22721,6,2003,2009,3,-122.770278,42.386111,"dissolved  sodium"
"5078",23160,4,2004,2008,2,-123.098056,43.303056,"dissolved  sodium"
"5079",23161,4,2004,2008,3,-123.100556,43.303056,"dissolved  sodium"
"5080",23162,4,2004,2008,3,-123.100556,43.305,"dissolved  sodium"
"5081",23163,4,2004,2008,2,-123.099444,43.305556,"dissolved  sodium"
"5082",23172,3,2001,2004,5,-122.86916,45.181111,"dissolved  sodium"
"5083",23176,1,2003,2004,2,-122.86,45.181667,"dissolved  sodium"
"5084",23195,9,2002,2011,10,-116.995,44.198333,"dissolved  sodium"
"5085",23196,2,2006,2008,2,-118.116667,45.3525,"dissolved  sodium"
"5086",23197,6,2002,2008,3,-118.121667,45.348333,"dissolved  sodium"
"5087",23198,6,2002,2008,5,-118.121944,45.347778,"dissolved  sodium"
"5088",23202,0,2002,2002,1,-118.121806,45.347917,"dissolved  sodium"
"5089",23242,0,2001,2001,2,-123.95,44.020833,"dissolved  sodium"
"5090",23260,4,2007,2011,3,-123.39694,42.498055,"dissolved  sodium"
"5091",23737,9,2002,2011,10,-116.99405,44.242883,"dissolved  sodium"
"5092",23753,1,2008,2009,10,-124.407222,42.371944,"dissolved  sodium"
"5093",23797,0,2001,2001,2,-122.826317,45.970117,"dissolved  sodium"
"5094",23800,0,2001,2001,1,-123.4242,46.220683,"dissolved  sodium"
"5095",24341,8,2003,2011,9,-117.0573,43.795233,"dissolved  sodium"
"5096",24344,0,2005,2005,1,NA,NA,"dissolved  sodium"
"5097",24391,0,2005,2005,1,-122.86306,45.84076,"dissolved  sodium"
"5098",24488,5,2002,2007,4,-123.93222,44.60538,"dissolved  sodium"
"5099",24489,9,2002,2011,5,-123.93369,44.60559,"dissolved  sodium"
"5100",24490,2,2002,2004,2,-123.92893,44.60188,"dissolved  sodium"
"5101",24491,0,2002,2002,1,-123.9316,44.6049,"dissolved  sodium"
"5102",24492,9,2002,2011,5,-123.92233,44.60043,"dissolved  sodium"
"5103",24548,5,2005,2010,3,-121.13755,45.56747,"dissolved  sodium"
"5104",24561,0,2009,2009,1,-123.37976,43.18707,"dissolved  sodium"
"5105",24562,0,2009,2009,1,-123.37969,43.18703,"dissolved  sodium"
"5106",24592,0,2002,2002,1,-123.12846,44.3158,"dissolved  sodium"
"5107",24676,10,2002,2012,4,-121.80452,42.17722,"dissolved  sodium"
"5108",24678,10,2002,2012,5,-121.80387,42.17511,"dissolved  sodium"
"5109",24679,10,2002,2012,4,-121.80475,42.1743,"dissolved  sodium"
"5110",10150,0,2002,2002,2,-123.266111,44.041111,"field  conductivity"
"5111",10151,2,2001,2003,23,-123.268611,44.005278,"field  conductivity"
"5112",10332,11,2001,2012,72,-122.7475,45.577944,"field  conductivity"
"5113",10339,11,2001,2012,93,-122.690722,45.300333,"field  conductivity"
"5114",10342,10,2001,2011,21,-122.942361,45.267639,"field  conductivity"
"5115",10344,11,2001,2012,125,-123.044306,45.090583,"field  conductivity"
"5116",10346,0,2005,2005,4,-123.041056,44.947167,"field  conductivity"
"5117",10350,11,2001,2012,154,-123.105778,44.639722,"field  conductivity"
"5118",10351,0,2010,2010,1,-123.163611,44.638056,"field  conductivity"
"5119",10352,11,2001,2012,195,-123.255417,44.565528,"field  conductivity"
"5120",10355,11,2001,2012,126,-123.173667,44.267167,"field  conductivity"
"5121",10359,11,2001,2012,59,-123.02675,44.045611,"field  conductivity"
"5122",10360,2,2008,2010,6,-122.600222,45.373528,"field  conductivity"
"5123",10362,5,2006,2011,67,-122.738028,45.259861,"field  conductivity"
"5124",10363,11,2001,2012,169,-123.071583,45.223639,"field  conductivity"
"5125",10364,8,2003,2011,68,-123.1463,44.928,"field  conductivity"
"5126",10366,11,2001,2012,69,-122.923556,44.636194,"field  conductivity"
"5127",10372,7,2004,2011,70,-123.111667,44.635556,"field  conductivity"
"5128",10373,11,2001,2012,73,-123.263639,44.556639,"field  conductivity"
"5129",10375,6,2002,2008,13,-123.294722,44.313028,"field  conductivity"
"5130",10376,11,2001,2012,134,-123.046194,44.112722,"field  conductivity"
"5131",10379,7,2004,2011,15,-122.9655,43.981,"field  conductivity"
"5132",10386,11,2001,2012,135,-122.905278,43.998194,"field  conductivity"
"5133",10391,11,2001,2012,65,-123.9135,44.7643,"field  conductivity"
"5134",10392,8,2001,2009,26,-123.852139,44.030139,"field  conductivity"
"5135",10393,11,2001,2012,76,-124.136694,43.078528,"field  conductivity"
"5136",10398,0,2003,2003,1,-116.999361,43.866639,"field  conductivity"
"5137",10401,1,2005,2006,24,-119.146514,44.415989,"field  conductivity"
"5138",10404,11,2001,2012,81,-119.035389,45.677444,"field  conductivity"
"5139",10405,0,2005,2005,2,-118.875611,45.65775,"field  conductivity"
"5140",10406,11,2001,2012,71,-118.7585,45.674806,"field  conductivity"
"5141",10407,11,2001,2012,67,-116.972222,44.05675,"field  conductivity"
"5142",10408,0,2006,2006,4,-117.141361,44.000222,"field  conductivity"
"5143",10410,11,2001,2012,61,-117.719639,45.621306,"field  conductivity"
"5144",10411,11,2001,2012,77,-120.910167,45.630222,"field  conductivity"
"5145",10413,3,2005,2008,7,-124.327472,42.481639,"field  conductivity"
"5146",10414,11,2001,2012,90,-124.292167,42.503667,"field  conductivity"
"5147",10418,11,2001,2012,73,-123.487278,42.496833,"field  conductivity"
"5148",10421,11,2001,2012,77,-123.089389,42.432694,"field  conductivity"
"5149",10423,11,2001,2012,92,-122.841583,42.525333,"field  conductivity"
"5150",10425,6,2002,2008,15,-124.063489,42.548747,"field  conductivity"
"5151",10428,11,2001,2012,60,-123.455833,42.3975,"field  conductivity"
"5152",10430,6,2002,2008,61,-122.898833,42.38225,"field  conductivity"
"5153",10433,6,2002,2008,58,-122.818333,42.280278,"field  conductivity"
"5154",10434,9,2002,2011,60,-122.744944,42.224417,"field  conductivity"
"5155",10437,11,2001,2012,70,-123.565833,43.631861,"field  conductivity"
"5156",10440,0,2002,2002,4,-123.467,43.366167,"field  conductivity"
"5157",10441,11,2001,2012,75,-123.563444,43.635139,"field  conductivity"
"5158",10442,11,2001,2012,75,-123.411056,43.241778,"field  conductivity"
"5159",10443,11,2001,2012,77,-123.397944,43.133889,"field  conductivity"
"5160",10444,0,2002,2002,2,-123.294889,43.025444,"field  conductivity"
"5161",10445,4,2002,2006,8,-123.284667,42.944056,"field  conductivity"
"5162",10451,11,2001,2012,57,-123.409222,43.271861,"field  conductivity"
"5163",10456,11,2001,2012,69,-122.756278,45.386139,"field  conductivity"
"5164",10458,11,2001,2012,62,-122.893667,45.409389,"field  conductivity"
"5165",10459,11,2001,2012,63,-122.919778,45.444415,"field  conductivity"
"5166",10461,11,2001,2012,63,-122.950556,45.490056,"field  conductivity"
"5167",10466,0,2008,2008,1,-123.124056,45.477639,"field  conductivity"
"5168",10469,11,2001,2012,75,-122.752778,45.415472,"field  conductivity"
"5169",10480,11,2001,2012,58,-122.89875,45.520861,"field  conductivity"
"5170",10506,11,2001,2012,58,-121.227806,44.761167,"field  conductivity"
"5171",10508,11,2001,2012,77,-121.293778,44.359917,"field  conductivity"
"5172",10509,1,2001,2002,7,-121.253861,44.268139,"field  conductivity"
"5173",10511,11,2001,2012,59,-121.320444,44.060083,"field  conductivity"
"5174",10517,11,2001,2012,65,-121.080694,44.348694,"field  conductivity"
"5175",10521,11,2001,2012,62,-123.9251,45.952,"field  conductivity"
"5176",10523,11,2001,2012,132,-123.8902,45.2071,"field  conductivity"
"5177",10526,7,2004,2011,133,-124.015139,44.967833,"field  conductivity"
"5178",10533,11,2001,2012,81,-124.481417,42.81675,"field  conductivity"
"5179",10535,1,2008,2009,8,-124.352306,42.277056,"field  conductivity"
"5180",10537,11,2001,2012,91,-124.186139,42.007139,"field  conductivity"
"5181",10555,11,2001,2012,123,-123.041528,44.946111,"field  conductivity"
"5182",10565,0,2006,2006,1,-123.099528,44.600278,"field  conductivity"
"5183",10577,0,2005,2005,1,-123.080278,44.6445,"field  conductivity"
"5184",10579,1,2004,2005,2,-122.642583,45.440333,"field  conductivity"
"5185",10582,3,2008,2011,4,-124.012583,44.92675,"field  conductivity"
"5186",10585,1,2007,2008,14,-123.751139,44.376111,"field  conductivity"
"5187",10588,0,2008,2008,2,-123.875583,44.534556,"field  conductivity"
"5188",10596,11,2001,2012,108,-124.192528,43.173778,"field  conductivity"
"5189",10599,6,2002,2008,11,-124.061667,42.58725,"field  conductivity"
"5190",10602,11,2001,2012,90,-122.855028,42.455444,"field  conductivity"
"5191",10607,0,2006,2006,6,-122.766694,45.652167,"field  conductivity"
"5192",10611,11,2001,2012,117,-122.669889,45.513306,"field  conductivity"
"5193",10616,11,2001,2012,58,-122.738861,45.645639,"field  conductivity"
"5194",10623,5,2006,2011,61,-122.640694,45.441917,"field  conductivity"
"5195",10637,11,2001,2012,139,-122.709222,45.267667,"field  conductivity"
"5196",10638,0,2008,2008,1,-122.537028,45.162694,"field  conductivity"
"5197",10640,11,2001,2012,68,-122.792528,45.150361,"field  conductivity"
"5198",10646,6,2005,2011,56,-122.824194,45.006583,"field  conductivity"
"5199",10647,0,2006,2006,4,-122.767528,44.989889,"field  conductivity"
"5200",10648,0,2005,2005,5,-122.997111,45.229778,"field  conductivity"
"5201",10652,0,2003,2003,7,-123.02275,44.945222,"field  conductivity"
"5202",10655,1,2002,2003,14,-123.037944,44.936111,"field  conductivity"
"5203",10656,0,2005,2005,3,-123.114583,44.929472,"field  conductivity"
"5204",10658,9,2002,2011,67,-123.161389,44.730361,"field  conductivity"
"5205",10659,6,2002,2008,16,-123.235333,44.782778,"field  conductivity"
"5206",10661,0,2002,2002,2,-123.355056,44.060444,"field  conductivity"
"5207",10662,11,2001,2012,88,-122.831222,44.055278,"field  conductivity"
"5208",10663,11,2001,2012,67,-122.959333,44.092306,"field  conductivity"
"5209",10674,11,2001,2012,61,-122.375444,45.5385,"field  conductivity"
"5210",10679,0,2008,2008,1,-121.631111,45.604917,"field  conductivity"
"5211",10681,1,2008,2009,29,-121.632861,45.604361,"field  conductivity"
"5212",10684,7,2001,2008,15,-121.410667,43.930806,"field  conductivity"
"5213",10686,11,2001,2012,63,-121.451194,43.863361,"field  conductivity"
"5214",10687,1,2001,2002,4,-121.4981,43.8174,"field  conductivity"
"5215",10688,11,2001,2012,61,-121.607028,43.743417,"field  conductivity"
"5216",10689,1,2001,2002,4,-121.688722,43.684417,"field  conductivity"
"5217",10690,11,2001,2012,69,-121.619528,44.5565,"field  conductivity"
"5218",10694,1,2001,2002,4,-121.463333,43.873028,"field  conductivity"
"5219",10696,11,2001,2012,54,-121.4513,43.8204,"field  conductivity"
"5220",10697,1,2001,2002,4,-121.500167,43.692306,"field  conductivity"
"5221",10698,1,2001,2002,4,-121.572028,43.661806,"field  conductivity"
"5222",10699,1,2001,2002,4,-121.6516,43.5248,"field  conductivity"
"5223",10703,8,2001,2009,8,-121.696889,43.463472,"field  conductivity"
"5224",10705,1,2001,2002,6,-121.5315,43.7943,"field  conductivity"
"5225",10708,0,2011,2011,3,-120.023139,45.739806,"field  conductivity"
"5226",10719,11,2001,2012,62,-117.909278,45.566889,"field  conductivity"
"5227",10720,11,2001,2012,66,-118.235556,45.342111,"field  conductivity"
"5228",10724,11,2001,2012,63,-117.4675,44.818333,"field  conductivity"
"5229",10725,1,2007,2008,26,-117.831889,44.737139,"field  conductivity"
"5230",10727,0,2006,2006,4,-117.363972,43.939472,"field  conductivity"
"5231",10728,11,2001,2012,65,-117.229167,43.988056,"field  conductivity"
"5232",10729,11,2001,2012,65,-117.054333,43.783861,"field  conductivity"
"5233",10730,4,2008,2012,5,-117.622806,42.840694,"field  conductivity"
"5234",10741,11,2001,2012,8,-119.901056,42.407139,"field  conductivity"
"5235",10743,2,2001,2003,6,-120.545028,42.696083,"field  conductivity"
"5236",10751,7,2001,2008,5,-120.389389,42.19325,"field  conductivity"
"5237",10758,0,2003,2003,5,-121.560417,42.010278,"field  conductivity"
"5238",10759,11,2001,2012,64,-121.622667,42.040417,"field  conductivity"
"5239",10762,0,2003,2003,2,-121.757694,42.154,"field  conductivity"
"5240",10763,11,2001,2012,68,-121.840722,42.079917,"field  conductivity"
"5241",10764,11,2001,2012,54,-122.059917,42.086917,"field  conductivity"
"5242",10765,11,2001,2012,66,-121.927778,42.128056,"field  conductivity"
"5243",10768,11,2001,2012,72,-121.788361,42.218778,"field  conductivity"
"5244",10770,11,2001,2012,58,-121.916194,42.514611,"field  conductivity"
"5245",10775,9,2002,2011,66,-123.012861,44.715389,"field  conductivity"
"5246",10792,11,2001,2012,67,-122.971111,44.708722,"field  conductivity"
"5247",10801,11,2001,2012,74,-122.709083,45.563806,"field  conductivity"
"5248",10802,6,2005,2011,67,-122.699972,45.558556,"field  conductivity"
"5249",10811,0,2003,2003,5,-123.915833,46.168583,"field  conductivity"
"5250",10812,11,2001,2012,68,-123.924361,46.148972,"field  conductivity"
"5251",10813,0,2003,2003,3,-123.9089,46.0944,"field  conductivity"
"5252",10817,11,2001,2012,68,-123.839972,46.075028,"field  conductivity"
"5253",10821,7,2004,2011,17,-122.763889,45.584722,"field  conductivity"
"5254",10827,1,2002,2003,3,-122.665778,45.473194,"field  conductivity"
"5255",10833,4,2007,2011,9,-122.640194,45.340472,"field  conductivity"
"5256",10853,1,2001,2002,8,-122.568333,45.467778,"field  conductivity"
"5257",10868,2,2009,2011,28,-122.353306,45.432722,"field  conductivity"
"5258",10873,5,2006,2011,59,-122.598667,45.364667,"field  conductivity"
"5259",10886,0,2005,2005,5,-122.756472,45.233639,"field  conductivity"
"5260",10887,0,2005,2005,1,-122.785278,45.205667,"field  conductivity"
"5261",10896,5,2002,2007,49,-122.7804,45.1477,"field  conductivity"
"5262",10898,0,2005,2005,1,-122.671083,45.047278,"field  conductivity"
"5263",10899,9,2002,2011,126,-122.8225,45.1004,"field  conductivity"
"5264",10909,0,2008,2008,3,-123.842194,44.731917,"field  conductivity"
"5265",10916,1,2004,2005,4,-122.654417,45.340528,"field  conductivity"
"5266",10917,11,2001,2012,148,-122.748972,45.233806,"field  conductivity"
"5267",10924,4,2007,2011,45,-123.108389,45.240194,"field  conductivity"
"5268",10929,11,2001,2012,112,-123.17417,45.25194,"field  conductivity"
"5269",10937,1,2005,2006,11,-123.229722,45.230194,"field  conductivity"
"5270",10948,11,2001,2012,74,-123.206917,45.168667,"field  conductivity"
"5271",10949,1,2008,2009,12,-123.263222,45.107917,"field  conductivity"
"5272",10952,1,2008,2009,11,-123.4975,45.052167,"field  conductivity"
"5273",10953,1,2008,2009,11,-123.56125,45.06475,"field  conductivity"
"5274",10957,0,2008,2008,4,-123.211806,45.116167,"field  conductivity"
"5275",10958,0,2003,2003,6,-123.265861,45.052667,"field  conductivity"
"5276",10959,0,2008,2008,3,-123.249222,45.084583,"field  conductivity"
"5277",10963,3,2006,2009,29,-123.276333,45.126278,"field  conductivity"
"5278",10967,3,2006,2009,31,-123.438611,45.079389,"field  conductivity"
"5279",10969,0,2006,2006,2,-123.486,45.079083,"field  conductivity"
"5280",10982,0,2007,2007,1,-123.879972,44.063,"field  conductivity"
"5281",10983,1,2007,2008,11,-123.658361,43.984639,"field  conductivity"
"5282",10984,1,2007,2008,10,-123.640028,43.929833,"field  conductivity"
"5283",10989,1,2007,2008,13,-123.608139,43.998694,"field  conductivity"
"5284",10990,1,2007,2008,11,-123.6205,43.954889,"field  conductivity"
"5285",10991,1,2002,2003,4,-122.967528,43.789139,"field  conductivity"
"5286",10993,1,2002,2003,4,-122.836917,43.695861,"field  conductivity"
"5287",10996,11,2001,2012,101,-123.459528,43.366361,"field  conductivity"
"5288",10997,11,2001,2012,79,-123.33575,42.943861,"field  conductivity"
"5289",11001,1,2002,2003,55,-123.9138,45.1528,"field  conductivity"
"5290",11003,3,2002,2005,57,-123.86088,45.229944,"field  conductivity"
"5291",11017,11,2001,2012,67,-119.637694,44.756,"field  conductivity"
"5292",11020,11,2001,2012,63,-119.531222,44.465639,"field  conductivity"
"5293",11043,11,2001,2012,59,-117.268861,43.967306,"field  conductivity"
"5294",11044,0,2006,2006,3,-117.603722,43.854389,"field  conductivity"
"5295",11047,9,2003,2012,8,-118.331778,43.783778,"field  conductivity"
"5296",11050,1,2011,2012,4,-117.518556,42.904917,"field  conductivity"
"5297",11051,11,2001,2012,129,-122.937722,42.404722,"field  conductivity"
"5298",11054,5,2006,2011,65,-123.272944,44.556056,"field  conductivity"
"5299",11111,0,2002,2002,6,-123.46775,44.681778,"field  conductivity"
"5300",11113,0,2002,2002,5,-123.180833,44.724889,"field  conductivity"
"5301",11114,0,2002,2002,7,-123.2915,44.797194,"field  conductivity"
"5302",11118,0,2002,2002,2,-123.386833,44.847944,"field  conductivity"
"5303",11123,6,2002,2008,92,-122.937306,42.403972,"field  conductivity"
"5304",11125,1,2007,2008,28,-122.924778,42.3895,"field  conductivity"
"5305",11128,6,2002,2008,99,-122.844667,42.314667,"field  conductivity"
"5306",11130,6,2002,2008,93,-122.779056,42.245556,"field  conductivity"
"5307",11133,6,2002,2008,96,-122.652139,42.185472,"field  conductivity"
"5308",11137,2,2001,2003,27,-123.285528,44.248333,"field  conductivity"
"5309",11138,2,2001,2003,26,-123.291417,44.216056,"field  conductivity"
"5310",11140,11,2001,2012,96,-123.294444,44.342861,"field  conductivity"
"5311",11142,0,2002,2002,5,-123.301639,44.118472,"field  conductivity"
"5312",11144,0,2002,2002,1,-123.426861,44.148111,"field  conductivity"
"5313",11148,0,2002,2002,2,-123.306083,43.99175,"field  conductivity"
"5314",11150,0,2002,2002,2,-123.261389,44.005,"field  conductivity"
"5315",11180,11,2001,2012,77,-123.127472,44.620222,"field  conductivity"
"5316",11182,9,2003,2012,12,-123.107472,44.504611,"field  conductivity"
"5317",11188,0,2003,2003,6,-123.112306,44.603556,"field  conductivity"
"5318",11201,11,2001,2012,79,-122.753056,45.6105,"field  conductivity"
"5319",11226,0,2002,2002,6,-123.842806,45.902083,"field  conductivity"
"5320",11233,11,2001,2012,57,-122.583139,45.378722,"field  conductivity"
"5321",11240,2,2006,2008,16,-121.547639,45.654806,"field  conductivity"
"5322",11241,11,2001,2012,211,-123.944972,45.023417,"field  conductivity"
"5323",11246,0,2008,2008,3,-123.790917,44.742722,"field  conductivity"
"5324",11253,4,2004,2008,47,-124.05375,44.729139,"field  conductivity"
"5325",11262,2,2007,2009,18,-123.941972,44.405306,"field  conductivity"
"5326",11263,11,2001,2012,86,-123.831,44.382694,"field  conductivity"
"5327",11270,1,2007,2008,10,-124.0985,44.30825,"field  conductivity"
"5328",11275,11,2001,2012,138,-122.985111,44.010028,"field  conductivity"
"5329",11278,1,2002,2003,5,-123.049139,43.718028,"field  conductivity"
"5330",11292,0,2011,2011,2,-123.183639,44.853889,"field  conductivity"
"5331",11304,3,2001,2004,15,-123.337306,43.658306,"field  conductivity"
"5332",11305,3,2001,2004,12,-123.316139,43.660361,"field  conductivity"
"5333",11306,4,2001,2005,12,-123.279333,43.604222,"field  conductivity"
"5334",11310,3,2001,2004,20,-123.341361,43.2135,"field  conductivity"
"5335",11316,2,2002,2004,12,-123.294944,43.022944,"field  conductivity"
"5336",11321,11,2001,2012,72,-122.64225,45.447167,"field  conductivity"
"5337",11323,1,2001,2002,6,-122.616111,45.461667,"field  conductivity"
"5338",11326,1,2001,2002,7,-122.467778,45.486111,"field  conductivity"
"5339",11372,0,2004,2004,7,-123.174111,42.433639,"field  conductivity"
"5340",11373,0,2004,2004,7,-123.159528,42.533139,"field  conductivity"
"5341",11375,0,2011,2011,3,-122.698944,42.659361,"field  conductivity"
"5342",11386,11,2001,2012,65,-120.468639,45.476861,"field  conductivity"
"5343",11412,1,2007,2008,7,-121.561389,45.499722,"field  conductivity"
"5344",11428,0,2001,2001,8,-123.843083,45.768361,"field  conductivity"
"5345",11434,11,2001,2012,75,-123.197583,46.102028,"field  conductivity"
"5346",11457,11,2001,2012,54,-117.729944,45.619556,"field  conductivity"
"5347",11461,0,2004,2004,7,-123.171583,42.439722,"field  conductivity"
"5348",11466,0,2004,2004,8,-123.02325,42.5845,"field  conductivity"
"5349",11476,11,2001,2012,106,-123.834778,44.657667,"field  conductivity"
"5350",11477,11,2001,2012,72,-120.541139,44.172556,"field  conductivity"
"5351",11478,11,2001,2012,88,-120.002694,44.792417,"field  conductivity"
"5352",11479,11,2001,2012,86,-119.470494,44.466331,"field  conductivity"
"5353",11480,11,2001,2012,71,-117.507583,43.910333,"field  conductivity"
"5354",11482,11,2001,2012,92,-123.68675,42.238389,"field  conductivity"
"5355",11483,11,2001,2012,77,-124.185889,42.123722,"field  conductivity"
"5356",11484,11,2001,2012,92,-123.21575,42.970944,"field  conductivity"
"5357",11485,11,2001,2012,90,-124.113167,43.032944,"field  conductivity"
"5358",11486,11,2001,2012,105,-124.149333,43.008528,"field  conductivity"
"5359",11489,11,2001,2012,66,-119.331944,45.835694,"field  conductivity"
"5360",11490,11,2001,2012,116,-117.826667,44.781944,"field  conductivity"
"5361",11491,6,2006,2012,50,-123.861972,43.788778,"field  conductivity"
"5362",11493,11,2001,2012,121,-124.395556,42.272222,"field  conductivity"
"5363",11494,11,2001,2012,63,-117.251947,44.356872,"field  conductivity"
"5364",11505,3,2006,2009,39,-123.199583,45.152722,"field  conductivity"
"5365",11506,6,2002,2008,57,-122.775333,42.245472,"field  conductivity"
"5366",11514,4,2005,2009,54,-122.783333,45.095333,"field  conductivity"
"5367",11515,4,2005,2009,59,-122.787222,45.088222,"field  conductivity"
"5368",11516,1,2010,2011,12,-122.785972,45.086028,"field  conductivity"
"5369",11517,0,2005,2005,1,-122.75625,45.086028,"field  conductivity"
"5370",11518,0,2005,2005,1,-122.762361,45.075333,"field  conductivity"
"5371",11521,11,2001,2012,58,-117.962611,45.349722,"field  conductivity"
"5372",11522,11,2001,2012,91,-123.365556,43.217778,"field  conductivity"
"5373",11523,6,2002,2008,56,-122.709861,42.215139,"field  conductivity"
"5374",11527,0,2005,2005,1,-123.178333,45.214444,"field  conductivity"
"5375",11535,5,2002,2007,27,-122.842361,45.009694,"field  conductivity"
"5376",11539,0,2005,2005,1,-123.116111,44.094722,"field  conductivity"
"5377",11542,0,2005,2005,2,-122.650278,45.424444,"field  conductivity"
"5378",11543,0,2005,2005,1,-118.838861,45.668556,"field  conductivity"
"5379",11545,0,2002,2002,1,-123.395722,43.211056,"field  conductivity"
"5380",11547,0,2005,2005,1,-123.053611,45.009444,"field  conductivity"
"5381",11551,0,2005,2005,1,-122.759444,45.404167,"field  conductivity"
"5382",11555,1,2004,2005,2,-122.656667,45.417778,"field  conductivity"
"5383",11571,9,2001,2010,31,-124.105972,43.071667,"field  conductivity"
"5384",11573,9,2001,2010,25,-124.345778,43.135056,"field  conductivity"
"5385",11574,6,2004,2010,21,-124.201,43.179444,"field  conductivity"
"5386",11586,0,2008,2008,2,-117.231772,45.397994,"field  conductivity"
"5387",11587,0,2008,2008,1,-117.232644,45.398289,"field  conductivity"
"5388",11598,0,2003,2003,8,-121.790667,42.178444,"field  conductivity"
"5389",11614,6,2002,2008,55,-122.651361,42.193083,"field  conductivity"
"5390",11626,7,2001,2008,23,-122.402278,45.473056,"field  conductivity"
"5391",11655,0,2002,2002,2,-122.529528,43.011083,"field  conductivity"
"5392",11656,0,2002,2002,2,-122.520361,43.010361,"field  conductivity"
"5393",11686,0,2002,2002,1,-124.141972,43.082194,"field  conductivity"
"5394",11692,9,2001,2010,25,-124.185889,43.096472,"field  conductivity"
"5395",11698,0,2007,2007,10,-124.189139,43.124528,"field  conductivity"
"5396",11704,0,2007,2007,12,-124.222139,43.177139,"field  conductivity"
"5397",11721,8,2002,2010,11,-124.357167,43.164833,"field  conductivity"
"5398",11724,0,2007,2007,2,-124.146611,43.06975,"field  conductivity"
"5399",11725,0,2007,2007,2,-124.193667,43.173583,"field  conductivity"
"5400",11740,0,2001,2001,1,-124.140417,43.080528,"field  conductivity"
"5401",11768,9,2001,2010,24,-124.289528,43.116111,"field  conductivity"
"5402",11778,1,2005,2006,8,-120.793333,44.109722,"field  conductivity"
"5403",11783,0,2010,2010,1,-123.186583,45.855056,"field  conductivity"
"5404",11787,0,2001,2001,4,-123.189194,45.855556,"field  conductivity"
"5405",11823,0,2004,2004,4,-122.802667,45.008417,"field  conductivity"
"5406",11825,0,2004,2004,2,-122.802722,45.008972,"field  conductivity"
"5407",11826,0,2009,2009,5,-120.599778,45.702889,"field  conductivity"
"5408",11849,0,2001,2001,5,-123.651778,45.750361,"field  conductivity"
"5409",11850,0,2007,2007,1,-124.105722,44.186639,"field  conductivity"
"5410",11856,11,2001,2012,75,-123.842444,45.700361,"field  conductivity"
"5411",11857,2,2010,2012,76,-117.171833,44.74625,"field  conductivity"
"5412",11859,0,2006,2006,2,-124.174417,43.484778,"field  conductivity"
"5413",11861,0,2006,2006,2,-124.130556,43.497778,"field  conductivity"
"5414",11868,6,2001,2007,20,-124.176556,43.458028,"field  conductivity"
"5415",11871,6,2001,2007,19,-124.139667,43.476806,"field  conductivity"
"5416",11872,6,2001,2007,18,-124.119972,43.487917,"field  conductivity"
"5417",11882,4,2001,2005,8,-124.318083,43.276472,"field  conductivity"
"5418",11884,2,2005,2007,5,-124.208111,43.356306,"field  conductivity"
"5419",11904,11,2001,2012,75,-123.751111,46.091167,"field  conductivity"
"5420",11905,11,2001,2012,77,-124.487889,42.794389,"field  conductivity"
"5421",11940,1,2004,2005,2,-122.7695,45.294167,"field  conductivity"
"5422",11943,1,2005,2006,7,-122.759889,45.293111,"field  conductivity"
"5423",11967,0,2005,2005,1,-121.543306,45.627167,"field  conductivity"
"5424",11968,0,2005,2005,4,-121.543222,45.626444,"field  conductivity"
"5425",11969,0,2005,2005,1,-121.543889,45.627972,"field  conductivity"
"5426",11971,0,2005,2005,4,-121.512917,45.644222,"field  conductivity"
"5427",11972,9,2002,2011,102,-121.51517,45.64377,"field  conductivity"
"5428",11973,0,2005,2005,2,-121.52925,45.627583,"field  conductivity"
"5429",11974,0,2005,2005,2,-121.527333,45.627722,"field  conductivity"
"5430",11990,1,2006,2007,3,-122.955222,44.024444,"field  conductivity"
"5431",12005,11,2001,2012,83,-118.823028,45.654444,"field  conductivity"
"5432",12012,11,2001,2012,172,-121.506722,45.710722,"field  conductivity"
"5433",12015,0,2011,2011,4,-119.341281,45.784772,"field  conductivity"
"5434",12026,1,2011,2012,3,-119.198083,45.74225,"field  conductivity"
"5435",12042,2,2006,2008,17,-121.664722,45.699167,"field  conductivity"
"5436",12044,1,2007,2008,3,-121.171111,45.601111,"field  conductivity"
"5437",12053,0,2001,2001,1,-118.4025,45.2624,"field  conductivity"
"5438",12054,0,2001,2001,1,-118.4043,45.2627,"field  conductivity"
"5439",12055,4,2001,2005,6,-118.4287,45.2697,"field  conductivity"
"5440",12057,4,2001,2005,6,-118.4017,45.2608,"field  conductivity"
"5441",12058,2,2001,2003,6,-118.5295,45.2699,"field  conductivity"
"5442",12059,2,2001,2003,5,-118.3828,45.275,"field  conductivity"
"5443",12061,2,2003,2005,17,-122.762694,44.9865,"field  conductivity"
"5444",12091,0,2007,2007,1,-123.982389,42.044306,"field  conductivity"
"5445",12092,0,2007,2007,1,-124.049472,42.457889,"field  conductivity"
"5446",12095,3,2005,2008,9,-124.089861,42.048972,"field  conductivity"
"5447",12099,6,2002,2008,13,-124.231306,42.488083,"field  conductivity"
"5448",12134,0,2007,2007,1,-123.944167,43.69,"field  conductivity"
"5449",12141,0,2006,2006,1,-118.081944,45.341944,"field  conductivity"
"5450",12166,0,2006,2006,9,-121.452472,45.704028,"field  conductivity"
"5451",12167,0,2008,2008,2,-121.785028,45.709417,"field  conductivity"
"5452",12181,2,2001,2003,6,-118.533,45.0912,"field  conductivity"
"5453",12182,2,2001,2003,5,-118.2985,45.107472,"field  conductivity"
"5454",12183,4,2001,2005,10,-118.3307,45.102556,"field  conductivity"
"5455",12187,11,2001,2012,64,-123.785583,46.069556,"field  conductivity"
"5456",12189,0,2005,2005,1,-118.833306,45.671639,"field  conductivity"
"5457",12212,0,2005,2005,27,-120.716583,44.299083,"field  conductivity"
"5458",12215,5,2002,2007,2,-123.253833,45.567306,"field  conductivity"
"5459",12243,0,2006,2006,1,-123.3575,43.071667,"field  conductivity"
"5460",12244,0,2004,2004,2,-123.287222,43.023889,"field  conductivity"
"5461",12245,4,2002,2006,16,-123.298333,43.016944,"field  conductivity"
"5462",12248,2,2002,2004,17,-123.4275,43.117778,"field  conductivity"
"5463",12251,2,2002,2004,12,-123.385556,43.080861,"field  conductivity"
"5464",12254,0,2006,2006,4,-123.330917,43.040861,"field  conductivity"
"5465",12257,2,2001,2003,3,-119.088583,43.652417,"field  conductivity"
"5466",12258,7,2001,2008,5,-117.729878,43.007536,"field  conductivity"
"5467",12260,5,2001,2006,4,-117.609444,42.805056,"field  conductivity"
"5468",12261,11,2001,2012,9,-116.995278,42.911389,"field  conductivity"
"5469",12262,7,2001,2008,5,-117.180944,42.52625,"field  conductivity"
"5470",12263,7,2001,2008,5,-117.156389,42.543944,"field  conductivity"
"5471",12264,11,2001,2012,7,-118.234111,42.337611,"field  conductivity"
"5472",12265,11,2001,2012,10,-118.866583,42.801083,"field  conductivity"
"5473",12266,11,2001,2012,11,-119.841944,42.176111,"field  conductivity"
"5474",12267,11,2001,2012,9,-119.926667,42.174444,"field  conductivity"
"5475",12269,5,2001,2006,4,-118.369333,42.187167,"field  conductivity"
"5476",12278,0,2007,2007,1,-123.588278,45.494944,"field  conductivity"
"5477",12301,1,2007,2008,21,-123.774778,44.635222,"field  conductivity"
"5478",12303,6,2002,2008,57,-122.866778,42.324833,"field  conductivity"
"5479",12308,6,2002,2008,93,-122.715722,42.214417,"field  conductivity"
"5480",12368,0,2002,2002,7,-123.9155,46.019,"field  conductivity"
"5481",12376,6,2002,2008,55,-122.787167,42.253778,"field  conductivity"
"5482",12377,6,2002,2008,61,-122.870667,42.332722,"field  conductivity"
"5483",12473,9,2001,2010,24,-124.077194,43.113139,"field  conductivity"
"5484",12476,9,2001,2010,25,-124.152139,43.052833,"field  conductivity"
"5485",12488,0,2001,2001,3,-121.94731,42.133347,"field  conductivity"
"5486",12490,0,2003,2003,5,-121.7775,41.996667,"field  conductivity"
"5487",12509,0,2007,2007,1,-123.439444,44.138889,"field  conductivity"
"5488",12511,1,2008,2009,7,-123.696222,45.091861,"field  conductivity"
"5489",12521,0,2007,2007,1,-123.971083,43.963306,"field  conductivity"
"5490",12534,6,2002,2008,93,-122.738722,42.222722,"field  conductivity"
"5491",12535,6,2002,2008,94,-122.810056,42.279139,"field  conductivity"
"5492",12536,6,2002,2008,93,-122.884278,42.36525,"field  conductivity"
"5493",12537,6,2002,2008,94,-122.924472,42.394417,"field  conductivity"
"5494",12543,0,2004,2004,2,-121.119278,45.450639,"field  conductivity"
"5495",12546,0,2005,2005,1,-121.118972,45.450639,"field  conductivity"
"5496",12547,0,2005,2005,1,-121.120194,45.450861,"field  conductivity"
"5497",12552,11,2001,2012,60,-122.161389,44.174167,"field  conductivity"
"5498",12553,11,2001,2012,59,-122.411667,44.752778,"field  conductivity"
"5499",12559,11,2001,2012,74,-122.048611,44.693222,"field  conductivity"
"5500",12560,1,2001,2002,5,-121.52883,43.77214,"field  conductivity"
"5501",12561,1,2001,2002,4,-121.305833,44.079167,"field  conductivity"
"5502",12564,0,2001,2001,1,-121.840194,43.496778,"field  conductivity"
"5503",12565,1,2001,2002,4,-121.677389,43.520778,"field  conductivity"
"5504",12566,7,2001,2008,8,-121.333833,44.461306,"field  conductivity"
"5505",12567,1,2001,2002,4,-121.4761,43.7705,"field  conductivity"
"5506",12568,2,2008,2010,3,-123.278361,42.942028,"field  conductivity"
"5507",12569,0,2010,2010,1,-123.279722,42.942694,"field  conductivity"
"5508",12570,6,2002,2008,8,-123.2805,42.942861,"field  conductivity"
"5509",12573,0,2002,2002,1,-123.279889,42.942556,"field  conductivity"
"5510",12587,3,2002,2005,41,-122.955806,42.426389,"field  conductivity"
"5511",12588,6,2002,2008,57,-122.935222,42.3895,"field  conductivity"
"5512",12590,11,2001,2012,115,-124.451694,42.916278,"field  conductivity"
"5513",12604,0,2009,2009,1,-124.179806,43.57175,"field  conductivity"
"5514",12605,0,2009,2009,1,-124.180111,43.571306,"field  conductivity"
"5515",12617,8,2004,2012,6,-117.828528,44.817083,"field  conductivity"
"5516",12624,1,2011,2012,10,-117.883944,45.01375,"field  conductivity"
"5517",12627,1,2011,2012,4,-117.900778,45.034722,"field  conductivity"
"5518",12655,4,2001,2005,21,-122.339778,44.155444,"field  conductivity"
"5519",12656,4,2001,2005,23,-122.259139,44.157333,"field  conductivity"
"5520",12657,4,2001,2005,18,-121.995611,44.35625,"field  conductivity"
"5521",12692,0,2003,2003,6,-123.929167,46.100278,"field  conductivity"
"5522",12719,1,2007,2008,26,-122.927056,42.362583,"field  conductivity"
"5523",12728,1,2007,2008,25,-122.919611,42.362694,"field  conductivity"
"5524",12796,4,2002,2006,22,-123.240833,43.443306,"field  conductivity"
"5525",12800,4,2002,2006,22,-123.3075,43.421111,"field  conductivity"
"5526",12803,4,2002,2006,26,-123.163861,43.409,"field  conductivity"
"5527",12807,0,2002,2002,12,-123.324417,43.416333,"field  conductivity"
"5528",12832,0,2007,2007,2,-123.857111,45.501278,"field  conductivity"
"5529",12866,0,2001,2001,13,-123.874444,45.733333,"field  conductivity"
"5530",12867,0,2001,2001,3,-123.830556,45.785556,"field  conductivity"
"5531",12868,0,2003,2003,3,-123.168611,44.055556,"field  conductivity"
"5532",12869,0,2003,2003,2,-123.154444,44.054444,"field  conductivity"
"5533",12899,2,2004,2006,32,-123.294056,43.022,"field  conductivity"
"5534",12900,0,2004,2004,4,-123.395278,43.2115,"field  conductivity"
"5535",12911,7,2002,2009,2,-123.355083,42.949972,"field  conductivity"
"5536",12913,0,2002,2002,3,-123.3565,42.949556,"field  conductivity"
"5537",12927,0,2009,2009,1,-123.777,45.471306,"field  conductivity"
"5538",12933,0,2009,2009,1,-123.724861,45.433972,"field  conductivity"
"5539",12974,0,2009,2009,1,-123.205556,46.107222,"field  conductivity"
"5540",12975,0,2009,2009,1,-123.207222,46.107222,"field  conductivity"
"5541",12978,0,2009,2009,1,-122.943056,46.091667,"field  conductivity"
"5542",12997,4,2001,2005,6,-118.4174,45.2665,"field  conductivity"
"5543",12999,1,2004,2005,2,-117.528658,45.577581,"field  conductivity"
"5544",13002,1,2004,2005,2,-117.529097,45.578061,"field  conductivity"
"5545",13014,11,2001,2012,9,-118.763167,42.63875,"field  conductivity"
"5546",13015,0,2009,2009,3,-123.735083,45.435333,"field  conductivity"
"5547",13039,0,2007,2007,2,-123.841806,45.468194,"field  conductivity"
"5548",13049,8,2002,2010,2,-123.430639,42.741167,"field  conductivity"
"5549",13050,8,2002,2010,2,-123.430611,42.738944,"field  conductivity"
"5550",13051,0,2010,2010,1,-123.430667,42.741417,"field  conductivity"
"5551",13053,0,2010,2010,1,-123.433639,42.74225,"field  conductivity"
"5552",13055,0,2006,2006,1,-116.998333,43.902222,"field  conductivity"
"5553",13056,0,2006,2006,3,-116.982778,43.875278,"field  conductivity"
"5554",13057,0,2006,2006,3,-116.988056,43.875833,"field  conductivity"
"5555",13064,0,2006,2006,1,-117.248056,44.354722,"field  conductivity"
"5556",13065,0,2006,2006,1,-117.250028,44.357167,"field  conductivity"
"5557",13066,0,2006,2006,1,-117.251917,44.357056,"field  conductivity"
"5558",13067,0,2006,2006,1,-117.255667,44.356417,"field  conductivity"
"5559",13068,0,2009,2009,2,-123.724028,45.433972,"field  conductivity"
"5560",13070,11,2001,2012,104,-122.360361,45.299389,"field  conductivity"
"5561",13073,0,2006,2006,1,-122.571806,42.546806,"field  conductivity"
"5562",13074,0,2006,2006,1,-122.567306,42.547694,"field  conductivity"
"5563",13075,0,2006,2006,1,-122.568944,42.547778,"field  conductivity"
"5564",13138,0,2002,2002,15,-121.612639,45.569694,"field  conductivity"
"5565",13140,0,2008,2008,5,-121.686417,45.556972,"field  conductivity"
"5566",13141,9,2002,2011,167,-121.524611,45.663722,"field  conductivity"
"5567",13148,4,2006,2010,24,-121.518972,45.699083,"field  conductivity"
"5568",13152,0,2008,2008,1,-121.635,45.600083,"field  conductivity"
"5569",13164,0,2006,2006,18,-121.563278,45.509111,"field  conductivity"
"5570",13171,0,2005,2005,2,-121.522028,45.62875,"field  conductivity"
"5571",13172,0,2005,2005,2,-121.543694,45.623917,"field  conductivity"
"5572",13173,0,2005,2005,4,-121.544222,45.631361,"field  conductivity"
"5573",13181,3,2003,2006,42,-121.585028,45.563583,"field  conductivity"
"5574",13182,0,2005,2005,16,-121.51525,45.520667,"field  conductivity"
"5575",13183,1,2005,2006,33,-121.499,45.593806,"field  conductivity"
"5576",13184,1,2005,2006,32,-121.499167,45.593417,"field  conductivity"
"5577",13185,0,2008,2008,4,-121.584694,45.662778,"field  conductivity"
"5578",13186,0,2008,2008,3,-121.550806,45.681611,"field  conductivity"
"5579",13195,3,2002,2005,3,-123.5225,45.245861,"field  conductivity"
"5580",13196,2,2003,2005,2,-123.483222,42.523528,"field  conductivity"
"5581",13216,0,2009,2009,3,-124.007806,43.490444,"field  conductivity"
"5582",13223,0,2007,2007,2,-123.742306,45.595028,"field  conductivity"
"5583",13229,0,2007,2007,2,-124.156639,42.437861,"field  conductivity"
"5584",13249,1,2010,2011,27,-121.542472,45.642361,"field  conductivity"
"5585",13263,0,2005,2005,1,-123.971944,44.216139,"field  conductivity"
"5586",13295,0,2001,2001,10,-123.8821,45.6916,"field  conductivity"
"5587",13296,0,2001,2001,6,-123.9013,45.6886,"field  conductivity"
"5588",13298,0,2001,2001,8,-123.930278,45.661111,"field  conductivity"
"5589",13319,0,2008,2008,2,-124.003333,44.893056,"field  conductivity"
"5590",13363,1,2008,2009,3,-124.077222,43.977222,"field  conductivity"
"5591",13364,1,2008,2009,4,-124.06,43.976667,"field  conductivity"
"5592",13368,11,2001,2012,9,-123.771417,45.722333,"field  conductivity"
"5593",13372,0,2001,2001,7,-124.1,43.709722,"field  conductivity"
"5594",13379,0,2005,2005,2,-124.264444,43.423056,"field  conductivity"
"5595",13384,2,2005,2007,4,-124.20725,43.373889,"field  conductivity"
"5596",13386,0,2006,2006,2,-124.208889,43.364167,"field  conductivity"
"5597",13388,2,2005,2007,8,-124.192778,43.356667,"field  conductivity"
"5598",13389,1,2006,2007,6,-124.206944,43.301389,"field  conductivity"
"5599",13405,9,2001,2010,39,-124.277278,43.153972,"field  conductivity"
"5600",13406,0,2007,2007,15,-124.191306,43.173917,"field  conductivity"
"5601",13411,11,2001,2012,72,-123.872306,45.575167,"field  conductivity"
"5602",13417,11,2001,2012,68,-123.842583,45.496306,"field  conductivity"
"5603",13421,11,2001,2012,60,-123.843111,45.478028,"field  conductivity"
"5604",13424,11,2001,2012,61,-123.735611,45.471806,"field  conductivity"
"5605",13428,5,2007,2012,47,-123.843889,45.465278,"field  conductivity"
"5606",13429,5,2007,2012,38,-123.809167,45.470833,"field  conductivity"
"5607",13430,5,2007,2012,50,-123.844444,45.459167,"field  conductivity"
"5608",13431,5,2007,2012,40,-123.85853,45.456389,"field  conductivity"
"5609",13433,11,2001,2012,60,-123.822778,45.429861,"field  conductivity"
"5610",13440,11,2001,2012,67,-123.824722,45.408611,"field  conductivity"
"5611",13450,1,2002,2003,55,-123.954,45.2119,"field  conductivity"
"5612",13518,2,2005,2007,2,-124.152083,43.366583,"field  conductivity"
"5613",13520,1,2001,2002,4,-124.318333,43.306667,"field  conductivity"
"5614",13524,2,2005,2007,3,-124.173667,43.380611,"field  conductivity"
"5615",13525,8,2002,2010,9,-124.399444,43.146944,"field  conductivity"
"5616",13530,8,2002,2010,17,-124.408333,43.1225,"field  conductivity"
"5617",13540,0,2006,2006,3,-124.192222,43.335556,"field  conductivity"
"5618",13542,2,2005,2007,3,-124.208889,43.403889,"field  conductivity"
"5619",13568,0,2009,2009,3,-124.023333,43.433056,"field  conductivity"
"5620",13569,0,2009,2009,3,-124.030556,43.425,"field  conductivity"
"5621",13570,11,2001,2012,77,-124.058583,43.405667,"field  conductivity"
"5622",13574,11,2001,2012,62,-124.083083,43.363861,"field  conductivity"
"5623",13575,6,2001,2007,18,-124.147278,43.288694,"field  conductivity"
"5624",13577,6,2001,2007,11,-124.155222,43.3365,"field  conductivity"
"5625",13578,0,2005,2005,2,-124.1575,43.343333,"field  conductivity"
"5626",13579,5,2002,2007,18,-124.172722,43.349444,"field  conductivity"
"5627",13581,2,2005,2007,5,-124.174722,43.363333,"field  conductivity"
"5628",13583,2,2005,2007,6,-124.204083,43.325778,"field  conductivity"
"5629",13584,6,2001,2007,9,-124.225278,43.340556,"field  conductivity"
"5630",13588,6,2001,2007,9,-124.188056,43.466111,"field  conductivity"
"5631",13589,5,2002,2007,11,-124.1925,43.462222,"field  conductivity"
"5632",13593,6,2001,2007,19,-124.169444,43.432222,"field  conductivity"
"5633",13594,6,2001,2007,10,-124.186944,43.4225,"field  conductivity"
"5634",13598,6,2001,2007,12,-124.229722,43.400556,"field  conductivity"
"5635",13601,0,2005,2005,2,-124.3085,43.339972,"field  conductivity"
"5636",13605,0,2005,2005,2,-124.233889,43.431389,"field  conductivity"
"5637",13640,0,2001,2001,7,-123.889528,45.709806,"field  conductivity"
"5638",13643,0,2001,2001,1,-124.1935,43.462528,"field  conductivity"
"5639",13674,0,2005,2005,2,-124.220889,43.435889,"field  conductivity"
"5640",13678,0,2009,2009,1,-124.04325,44.424889,"field  conductivity"
"5641",13680,0,2010,2010,1,-124.412944,43.12075,"field  conductivity"
"5642",13707,0,2001,2001,5,-124.108056,43.705833,"field  conductivity"
"5643",13750,1,2002,2003,4,-123.055556,43.711389,"field  conductivity"
"5644",13769,1,2002,2003,4,-122.95,43.783333,"field  conductivity"
"5645",13781,0,2002,2002,8,-122.346389,42.378056,"field  conductivity"
"5646",13782,1,2004,2005,19,-124.505139,42.896361,"field  conductivity"
"5647",13807,0,2004,2004,47,-121.774294,43.925019,"field  conductivity"
"5648",13945,0,2002,2002,12,-122.154333,43.170278,"field  conductivity"
"5649",13959,0,2003,2003,5,-123.903056,46.084167,"field  conductivity"
"5650",14008,11,2001,2012,64,-122.150861,45.162722,"field  conductivity"
"5651",14018,5,2005,2010,77,-124.118972,43.548111,"field  conductivity"
"5652",14042,3,2002,2005,3,-122.85,42.314167,"field  conductivity"
"5653",14182,5,2002,2007,2,-124.0585,44.6979,"field  conductivity"
"5654",14183,0,2002,2002,1,-124.0595,44.697,"field  conductivity"
"5655",14185,0,2002,2002,1,-124.0593,44.6967,"field  conductivity"
"5656",14187,5,2002,2007,3,-124.0593,44.6963,"field  conductivity"
"5657",14192,0,2002,2002,1,-124.058889,44.696111,"field  conductivity"
"5658",14225,0,2011,2011,1,-122.736944,42.2625,"field  conductivity"
"5659",14226,0,2011,2011,1,-122.732778,42.268889,"field  conductivity"
"5660",14228,0,2011,2011,1,-122.735,42.261944,"field  conductivity"
"5661",14240,8,2002,2010,3,-117.778611,44.708056,"field  conductivity"
"5662",14241,8,2002,2010,6,-117.783056,44.706111,"field  conductivity"
"5663",14242,8,2002,2010,5,-117.784167,44.706111,"field  conductivity"
"5664",14243,8,2002,2010,5,-117.784167,44.704722,"field  conductivity"
"5665",14244,5,2005,2010,2,-124.355833,43.202778,"field  conductivity"
"5666",14245,5,2005,2010,2,-124.350278,43.208056,"field  conductivity"
"5667",14246,5,2005,2010,2,-124.350556,43.207778,"field  conductivity"
"5668",14247,5,2005,2010,2,-124.356111,43.2025,"field  conductivity"
"5669",14248,5,2005,2010,2,-124.350833,43.208889,"field  conductivity"
"5670",14249,5,2005,2010,4,-124.351944,43.206389,"field  conductivity"
"5671",14254,0,2005,2005,1,-122.878889,45.851389,"field  conductivity"
"5672",14255,0,2005,2005,1,-122.886111,45.850833,"field  conductivity"
"5673",14256,0,2005,2005,1,-122.88,45.850556,"field  conductivity"
"5674",14257,0,2005,2005,1,-122.881389,45.849722,"field  conductivity"
"5675",14258,0,2005,2005,1,-122.879167,45.85,"field  conductivity"
"5676",14259,0,2005,2005,2,-122.878889,45.849722,"field  conductivity"
"5677",14260,0,2005,2005,1,-122.878333,45.849444,"field  conductivity"
"5678",14263,0,2005,2005,1,-122.881667,45.85,"field  conductivity"
"5679",14266,0,2002,2002,1,-124.316111,43.205278,"field  conductivity"
"5680",14267,4,2005,2009,4,-124.316944,43.208611,"field  conductivity"
"5681",14268,0,2009,2009,1,-124.316389,43.210278,"field  conductivity"
"5682",14314,0,2002,2002,1,-123.081111,44.922778,"field  conductivity"
"5683",14320,0,2002,2002,1,-123.078611,44.925833,"field  conductivity"
"5684",14321,0,2002,2002,1,-123.078611,44.925833,"field  conductivity"
"5685",14322,0,2002,2002,1,-123.078611,44.925833,"field  conductivity"
"5686",14334,0,2002,2002,2,-123.091944,44.920833,"field  conductivity"
"5687",14393,4,2002,2006,3,-123.94616,46.16115,"field  conductivity"
"5688",14421,0,2001,2001,1,-122.948333,44.023056,"field  conductivity"
"5689",14422,0,2001,2001,1,-122.945556,44.024167,"field  conductivity"
"5690",14423,0,2001,2001,1,-122.945556,44.024167,"field  conductivity"
"5691",14425,0,2009,2009,1,-123.232778,44.696667,"field  conductivity"
"5692",14429,0,2006,2006,1,-123.236389,44.696667,"field  conductivity"
"5693",14434,0,2009,2009,1,-123.244444,44.697778,"field  conductivity"
"5694",14435,0,2006,2006,2,-123.246111,44.699444,"field  conductivity"
"5695",14444,0,2006,2006,1,-123.239167,44.697222,"field  conductivity"
"5696",14445,0,2009,2009,1,-123.239167,44.697222,"field  conductivity"
"5697",14459,0,2006,2006,1,-123.225278,44.699722,"field  conductivity"
"5698",14460,0,2009,2009,2,-123.227778,44.698611,"field  conductivity"
"5699",14463,7,2001,2008,6,-120.201528,45.7175,"field  conductivity"
"5700",14469,0,2009,2009,1,-120.259306,45.625278,"field  conductivity"
"5701",14473,6,2001,2007,8,-120.252222,45.622417,"field  conductivity"
"5702",14474,0,2007,2007,1,-120.25225,45.622417,"field  conductivity"
"5703",14475,9,2001,2010,18,-120.252111,45.622222,"field  conductivity"
"5704",14476,5,2002,2007,8,-120.255333,45.629333,"field  conductivity"
"5705",14477,0,2009,2009,1,-120.254917,45.619917,"field  conductivity"
"5706",14481,0,2001,2001,4,-120.257,45.619917,"field  conductivity"
"5707",14482,8,2001,2009,3,-120.256944,45.619917,"field  conductivity"
"5708",14483,0,2008,2008,3,-120.3765,45.618444,"field  conductivity"
"5709",14488,3,2001,2004,5,-120.251389,45.622778,"field  conductivity"
"5710",14498,0,2003,2003,1,-120.257111,45.620917,"field  conductivity"
"5711",14500,6,2001,2007,6,-120.253528,45.622333,"field  conductivity"
"5712",14509,7,2001,2008,6,-120.287417,45.603194,"field  conductivity"
"5713",14510,7,2001,2008,8,-120.295528,45.574944,"field  conductivity"
"5714",14511,7,2001,2008,5,-120.299917,45.572111,"field  conductivity"
"5715",14530,0,2011,2011,1,-121.519444,43.732222,"field  conductivity"
"5716",14534,0,2011,2011,1,-121.458333,43.741389,"field  conductivity"
"5717",14536,0,2011,2011,1,-121.461944,43.768611,"field  conductivity"
"5718",14540,0,2011,2011,1,-121.433889,43.825833,"field  conductivity"
"5719",14541,0,2011,2011,1,-121.433611,43.827778,"field  conductivity"
"5720",14556,0,2011,2011,2,-121.591389,43.613056,"field  conductivity"
"5721",14557,0,2011,2011,1,-121.574167,43.645833,"field  conductivity"
"5722",14560,0,2011,2011,1,-121.566667,43.632222,"field  conductivity"
"5723",14568,0,2011,2011,1,-121.509444,43.679167,"field  conductivity"
"5724",14569,0,2011,2011,1,-121.603611,43.615278,"field  conductivity"
"5725",14571,0,2011,2011,1,-121.505,43.646111,"field  conductivity"
"5726",14573,0,2011,2011,1,-121.505556,43.647222,"field  conductivity"
"5727",14575,0,2011,2011,1,-121.554444,43.675833,"field  conductivity"
"5728",14578,0,2011,2011,1,-121.582778,43.700833,"field  conductivity"
"5729",14579,0,2011,2011,2,-121.579722,43.684722,"field  conductivity"
"5730",14585,0,2011,2011,1,-121.550833,43.697222,"field  conductivity"
"5731",14592,0,2011,2011,1,-121.488339,43.716352,"field  conductivity"
"5732",14593,0,2011,2011,1,-121.488611,43.734444,"field  conductivity"
"5733",14594,0,2011,2011,1,-121.472222,43.734444,"field  conductivity"
"5734",14596,0,2011,2011,1,-121.48,43.862778,"field  conductivity"
"5735",14598,0,2011,2011,1,-121.481111,43.855833,"field  conductivity"
"5736",14599,0,2011,2011,1,-121.506944,43.76,"field  conductivity"
"5737",14600,0,2011,2011,2,-121.542222,43.7525,"field  conductivity"
"5738",14607,0,2011,2011,2,-121.535,43.7725,"field  conductivity"
"5739",14610,0,2011,2011,1,-121.481944,43.818333,"field  conductivity"
"5740",14619,0,2011,2011,2,-121.423333,43.822222,"field  conductivity"
"5741",14620,0,2011,2011,1,-121.461944,43.811944,"field  conductivity"
"5742",14623,0,2011,2011,1,-121.483056,43.783056,"field  conductivity"
"5743",14627,0,2011,2011,1,-121.538889,43.740556,"field  conductivity"
"5744",14632,0,2011,2011,1,-121.541389,43.744167,"field  conductivity"
"5745",14635,0,2011,2011,1,-121.6043,43.6254,"field  conductivity"
"5746",14638,0,2011,2011,2,-121.472,43.7328,"field  conductivity"
"5747",14640,0,2011,2011,1,-121.561944,43.6175,"field  conductivity"
"5748",14718,0,2011,2011,1,-121.569472,43.791944,"field  conductivity"
"5749",14719,0,2011,2011,1,-121.573083,43.789722,"field  conductivity"
"5750",14720,0,2011,2011,1,-121.545306,43.723889,"field  conductivity"
"5751",14721,0,2011,2011,1,-121.5075,43.670278,"field  conductivity"
"5752",14722,0,2011,2011,2,-121.514444,43.6775,"field  conductivity"
"5753",14726,0,2011,2011,1,-121.426667,43.903333,"field  conductivity"
"5754",14727,0,2011,2011,2,-121.442778,43.862778,"field  conductivity"
"5755",14728,0,2011,2011,1,-121.554472,43.708611,"field  conductivity"
"5756",14730,0,2011,2011,1,-121.540028,43.744444,"field  conductivity"
"5757",14732,0,2003,2003,1,-122.768056,42.376667,"field  conductivity"
"5758",14734,3,2003,2006,2,-122.774444,42.376111,"field  conductivity"
"5759",14741,6,2003,2009,3,-122.770833,42.385556,"field  conductivity"
"5760",14742,0,2009,2009,1,-122.771667,42.375833,"field  conductivity"
"5761",14743,0,2003,2003,1,-122.773333,42.386667,"field  conductivity"
"5762",14754,6,2005,2011,2,-122.588889,45.568056,"field  conductivity"
"5763",14776,0,2003,2003,1,-122.447361,45.55875,"field  conductivity"
"5764",14804,0,2004,2004,1,-122.806667,45.623056,"field  conductivity"
"5765",14805,0,2004,2004,1,-122.81,45.624722,"field  conductivity"
"5766",14806,0,2004,2004,1,-122.811389,45.625833,"field  conductivity"
"5767",14807,0,2004,2004,1,-122.806389,45.625833,"field  conductivity"
"5768",14809,6,2002,2008,3,-119.581389,45.686389,"field  conductivity"
"5769",14810,6,2002,2008,4,-119.586111,45.683611,"field  conductivity"
"5770",14811,6,2002,2008,3,-119.580833,45.689722,"field  conductivity"
"5771",14812,6,2002,2008,4,-119.583333,45.690556,"field  conductivity"
"5772",14813,6,2002,2008,3,-119.601111,45.686389,"field  conductivity"
"5773",14814,6,2002,2008,4,-119.591389,45.699722,"field  conductivity"
"5774",14822,5,2007,2012,2,-124.116111,43.984167,"field  conductivity"
"5775",14823,5,2007,2012,2,-124.118889,43.989167,"field  conductivity"
"5776",14824,5,2007,2012,4,-124.113889,43.988333,"field  conductivity"
"5777",14830,6,2004,2010,2,-120.21725,45.657917,"field  conductivity"
"5778",14831,6,2004,2010,3,-120.223333,45.646778,"field  conductivity"
"5779",14832,6,2004,2010,5,-120.204972,45.655528,"field  conductivity"
"5780",14833,6,2004,2010,3,-120.209722,45.661611,"field  conductivity"
"5781",14857,0,2011,2011,1,-123.271333,42.427333,"field  conductivity"
"5782",14931,3,2002,2005,2,-122.976667,45.498056,"field  conductivity"
"5783",14934,3,2002,2005,3,-122.969444,45.495,"field  conductivity"
"5784",14939,3,2002,2005,3,-122.980278,45.494167,"field  conductivity"
"5785",14940,8,2002,2010,4,-122.979444,45.495278,"field  conductivity"
"5786",14941,0,2002,2002,1,-122.978889,45.497222,"field  conductivity"
"5787",15009,7,2002,2009,3,-124.292222,43.316667,"field  conductivity"
"5788",15011,0,2006,2006,1,-124.298056,43.321389,"field  conductivity"
"5789",15012,7,2002,2009,3,-124.298056,43.317778,"field  conductivity"
"5790",15013,7,2002,2009,2,-124.295833,43.319167,"field  conductivity"
"5791",15015,7,2002,2009,3,-124.289167,43.318333,"field  conductivity"
"5792",15016,0,2002,2002,1,-124.297778,43.319444,"field  conductivity"
"5793",15020,0,2006,2006,1,-124.291111,43.316667,"field  conductivity"
"5794",15039,0,2003,2003,1,-123.623611,42.214722,"field  conductivity"
"5795",15116,9,2002,2011,4,-121.250278,44.013056,"field  conductivity"
"5796",15117,0,2002,2002,1,-121.253889,44.012222,"field  conductivity"
"5797",15118,0,2002,2002,1,-121.253056,44.008056,"field  conductivity"
"5798",15119,6,2002,2008,3,-122.8725,45.409722,"field  conductivity"
"5799",15120,8,2002,2010,4,-122.871944,45.407222,"field  conductivity"
"5800",15121,8,2002,2010,4,-122.870833,45.408889,"field  conductivity"
"5801",15122,8,2002,2010,4,-122.870278,45.408333,"field  conductivity"
"5802",15123,8,2002,2010,5,-122.872778,45.408333,"field  conductivity"
"5803",15124,8,2002,2010,4,-122.872778,45.408611,"field  conductivity"
"5804",15125,8,2002,2010,5,-122.869167,45.408333,"field  conductivity"
"5805",15126,8,2002,2010,5,-122.870833,45.408333,"field  conductivity"
"5806",15144,11,2001,2012,60,-117.229167,43.988056,"field  conductivity"
"5807",15151,11,2001,2012,64,-117.035,44.011,"field  conductivity"
"5808",15155,11,2001,2012,57,-116.955,44.02,"field  conductivity"
"5809",15169,11,2001,2012,64,-117.01,44.026,"field  conductivity"
"5810",15174,11,2001,2012,65,-117.023,44.013,"field  conductivity"
"5811",15180,11,2001,2012,61,-117.011,43.988,"field  conductivity"
"5812",15183,11,2001,2012,62,-116.99,43.962,"field  conductivity"
"5813",15186,11,2001,2012,67,-117.023,43.997,"field  conductivity"
"5814",15201,11,2001,2012,25,-116.995,44.199,"field  conductivity"
"5815",15203,11,2001,2012,65,-116.963,44.096,"field  conductivity"
"5816",15216,11,2001,2012,60,-116.985,43.895,"field  conductivity"
"5817",15217,11,2001,2012,66,-116.994,43.923,"field  conductivity"
"5818",15221,11,2001,2012,58,-116.993,43.953,"field  conductivity"
"5819",15229,11,2001,2012,67,-117.078,44.01,"field  conductivity"
"5820",15233,11,2001,2012,66,-117.268861,43.967306,"field  conductivity"
"5821",15234,11,2001,2012,39,-117.018,44.019,"field  conductivity"
"5822",15236,11,2001,2012,71,-117.004,43.931,"field  conductivity"
"5823",15244,11,2001,2012,39,-117.260194,44.026639,"field  conductivity"
"5824",15249,11,2001,2012,62,-117.08,43.997,"field  conductivity"
"5825",15253,11,2001,2012,61,-117.185,44.003,"field  conductivity"
"5826",15254,11,2001,2012,50,-117.237,43.986,"field  conductivity"
"5827",15257,11,2001,2012,61,-117.228,43.994,"field  conductivity"
"5828",15264,11,2001,2012,68,-117.049944,43.995833,"field  conductivity"
"5829",15275,11,2001,2012,59,-116.99,44.062,"field  conductivity"
"5830",15280,10,2001,2011,29,-116.989,44.061,"field  conductivity"
"5831",15281,0,2002,2002,1,-117.233333,43.986111,"field  conductivity"
"5832",15284,10,2001,2011,44,-117.2925,43.909722,"field  conductivity"
"5833",15289,11,2001,2012,59,-116.995,44.198333,"field  conductivity"
"5834",15291,11,2001,2012,74,-117.175,44.136111,"field  conductivity"
"5835",15294,11,2001,2012,63,-117.248333,43.966667,"field  conductivity"
"5836",15302,10,2001,2011,40,-117.061111,43.992222,"field  conductivity"
"5837",15327,11,2001,2012,59,-117.035278,44.010833,"field  conductivity"
"5838",15328,11,2001,2012,70,-117.004167,44.230556,"field  conductivity"
"5839",15329,11,2001,2012,63,-117.004194,43.894444,"field  conductivity"
"5840",15330,6,2005,2011,2,-122.699167,45.591667,"field  conductivity"
"5841",15331,6,2005,2011,3,-122.700833,45.591944,"field  conductivity"
"5842",15361,4,2007,2011,3,-123.396944,42.501389,"field  conductivity"
"5843",15363,4,2007,2011,2,-123.397222,42.501944,"field  conductivity"
"5844",15387,4,2007,2011,2,-123.398056,42.504722,"field  conductivity"
"5845",15446,0,2008,2008,1,-122.580833,45.5625,"field  conductivity"
"5846",15450,6,2005,2011,2,-122.583889,45.563056,"field  conductivity"
"5847",15451,3,2005,2008,3,-122.587278,45.566833,"field  conductivity"
"5848",15452,6,2005,2011,5,-122.585806,45.566556,"field  conductivity"
"5849",15453,6,2005,2011,3,-122.5845,45.566167,"field  conductivity"
"5850",15457,3,2005,2008,2,-122.975556,45.282222,"field  conductivity"
"5851",15459,3,2005,2008,4,-122.973889,45.2825,"field  conductivity"
"5852",15499,0,2009,2009,2,-122.387778,45.525556,"field  conductivity"
"5853",15500,0,2009,2009,1,-122.387778,45.523056,"field  conductivity"
"5854",15508,0,2002,2002,2,-123.105556,44.601944,"field  conductivity"
"5855",15509,0,2002,2002,1,-123.106389,44.601667,"field  conductivity"
"5856",15510,0,2002,2002,1,-123.105,44.603056,"field  conductivity"
"5857",15511,0,2002,2002,1,-123.106111,44.602778,"field  conductivity"
"5858",15517,11,2001,2012,64,-117.155,43.796,"field  conductivity"
"5859",15525,7,2001,2008,6,-117.055944,43.796,"field  conductivity"
"5860",15538,11,2001,2012,66,-117.24425,43.643056,"field  conductivity"
"5861",15540,11,2001,2012,62,-117.111111,43.780556,"field  conductivity"
"5862",15541,11,2001,2012,60,-117.145833,43.786111,"field  conductivity"
"5863",15542,7,2001,2008,2,-124.5075,42.771944,"field  conductivity"
"5864",15543,0,2008,2008,2,-124.508889,42.769444,"field  conductivity"
"5865",15546,7,2001,2008,3,-124.505,42.768611,"field  conductivity"
"5866",15548,0,2008,2008,1,-124.508056,42.767778,"field  conductivity"
"5867",15569,0,2008,2008,1,-124.071111,43.690833,"field  conductivity"
"5868",15574,0,2008,2008,1,-124.068056,43.688333,"field  conductivity"
"5869",15577,0,2008,2008,1,-124.07,43.688333,"field  conductivity"
"5870",15578,0,2008,2008,1,-124.071389,43.690556,"field  conductivity"
"5871",15581,0,2008,2008,2,-124.067778,43.688889,"field  conductivity"
"5872",15611,6,2002,2008,2,-123.246944,45.157778,"field  conductivity"
"5873",15612,6,2002,2008,2,-123.246944,45.158056,"field  conductivity"
"5874",15615,6,2002,2008,2,-123.242222,45.160556,"field  conductivity"
"5875",15617,0,2008,2008,1,-123.25,45.158056,"field  conductivity"
"5876",15618,0,2008,2008,1,-123.249722,45.157778,"field  conductivity"
"5877",15619,0,2008,2008,1,-123.243333,45.159444,"field  conductivity"
"5878",15663,0,2011,2011,1,-123.419444,42.439722,"field  conductivity"
"5879",15669,0,2011,2011,1,-123.271111,42.425278,"field  conductivity"
"5880",15682,0,2011,2011,1,-122.830833,42.425278,"field  conductivity"
"5881",15690,0,2011,2011,1,-122.9325,42.359444,"field  conductivity"
"5882",15697,0,2006,2006,1,-123.3772,43.1847,"field  conductivity"
"5883",15700,0,2006,2006,1,-123.3876,43.1851,"field  conductivity"
"5884",15704,3,2006,2009,2,-123.378611,43.185833,"field  conductivity"
"5885",15705,3,2006,2009,3,-123.378611,43.185833,"field  conductivity"
"5886",15719,0,2009,2009,1,-123.381944,43.191389,"field  conductivity"
"5887",15721,0,2006,2006,1,-123.365278,43.187222,"field  conductivity"
"5888",15723,3,2006,2009,2,-123.376111,43.184722,"field  conductivity"
"5889",15724,0,2009,2009,1,-123.375833,43.184444,"field  conductivity"
"5890",15725,3,2006,2009,3,-123.377778,43.184722,"field  conductivity"
"5891",15727,0,2009,2009,1,-123.380278,43.186389,"field  conductivity"
"5892",15755,0,2002,2002,2,-122.591167,45.369,"field  conductivity"
"5893",15785,3,2006,2009,2,-123.012222,43.954444,"field  conductivity"
"5894",15789,3,2006,2009,3,-122.997722,43.957,"field  conductivity"
"5895",15791,3,2006,2009,2,-122.993472,43.956111,"field  conductivity"
"5896",15798,3,2006,2009,3,-122.991639,43.955861,"field  conductivity"
"5897",15834,0,2002,2002,1,-121.445,43.782778,"field  conductivity"
"5898",15835,0,2002,2002,1,-121.446389,43.782778,"field  conductivity"
"5899",15837,0,2002,2002,1,-121.444861,43.782778,"field  conductivity"
"5900",15838,0,2002,2002,2,-121.444722,43.783056,"field  conductivity"
"5901",15866,6,2003,2009,2,-122.949444,42.305833,"field  conductivity"
"5902",15868,6,2003,2009,2,-122.954722,42.303889,"field  conductivity"
"5903",15869,6,2003,2009,2,-122.953889,42.304444,"field  conductivity"
"5904",15870,6,2003,2009,4,-122.954167,42.303611,"field  conductivity"
"5905",15913,0,2011,2011,1,-122.759167,45.620833,"field  conductivity"
"5906",15914,0,2011,2011,1,-122.757778,45.618056,"field  conductivity"
"5907",15916,0,2011,2011,1,-122.761389,45.615833,"field  conductivity"
"5908",15917,0,2008,2008,2,-122.761389,45.615833,"field  conductivity"
"5909",15924,0,2011,2011,1,-122.745,45.613056,"field  conductivity"
"5910",15935,0,2002,2002,1,-122.752333,45.618806,"field  conductivity"
"5911",15936,6,2002,2008,2,-122.752333,45.618806,"field  conductivity"
"5912",15937,0,2002,2002,1,-122.744167,45.615444,"field  conductivity"
"5913",15938,6,2002,2008,2,-122.744167,45.615444,"field  conductivity"
"5914",15940,9,2002,2011,2,-122.753889,45.618889,"field  conductivity"
"5915",15941,6,2002,2008,3,-122.745306,45.605694,"field  conductivity"
"5916",15942,0,2002,2002,1,-122.745306,45.605694,"field  conductivity"
"5917",15947,3,2008,2011,2,-122.758611,45.618056,"field  conductivity"
"5918",15949,0,2002,2002,1,-122.743889,45.614306,"field  conductivity"
"5919",15968,0,2005,2005,1,-123.839722,45.416389,"field  conductivity"
"5920",15970,0,2005,2005,1,-123.837222,45.416111,"field  conductivity"
"5921",15971,0,2005,2005,1,-123.836111,45.417222,"field  conductivity"
"5922",15972,0,2005,2005,1,-123.84,45.408889,"field  conductivity"
"5923",15978,0,2005,2005,1,-123.836667,45.416667,"field  conductivity"
"5924",15979,0,2005,2005,1,-123.836667,45.416667,"field  conductivity"
"5925",15985,0,2005,2005,1,-123.852222,45.415556,"field  conductivity"
"5926",15986,0,2005,2005,2,-123.85225,45.415556,"field  conductivity"
"5927",15987,0,2005,2005,1,-123.851944,45.411667,"field  conductivity"
"5928",15990,0,2005,2005,1,-123.847222,45.416389,"field  conductivity"
"5929",15992,0,2003,2003,1,-119.667583,45.827861,"field  conductivity"
"5930",15993,0,2003,2003,1,-119.663944,45.822278,"field  conductivity"
"5931",16009,0,2009,2009,1,-119.67525,45.818722,"field  conductivity"
"5932",16016,0,2003,2003,1,-119.49125,45.90075,"field  conductivity"
"5933",16018,7,2001,2008,35,-119.6881,45.8296,"field  conductivity"
"5934",16019,11,2001,2012,55,-119.7083,45.8194,"field  conductivity"
"5935",16022,0,2003,2003,1,-119.534278,45.8935,"field  conductivity"
"5936",16023,11,2001,2012,72,-119.5315,45.8973,"field  conductivity"
"5937",16024,11,2001,2012,60,-119.5395,45.9023,"field  conductivity"
"5938",16026,6,2003,2009,2,-119.504389,45.894417,"field  conductivity"
"5939",16028,11,2001,2012,52,-119.3282,45.9196,"field  conductivity"
"5940",16029,1,2001,2002,7,-119.2732,45.8651,"field  conductivity"
"5941",16030,0,2003,2003,1,-119.244028,45.869056,"field  conductivity"
"5942",16031,6,2003,2009,2,-119.237111,45.858139,"field  conductivity"
"5943",16032,0,2003,2003,1,-119.241139,45.839611,"field  conductivity"
"5944",16035,0,2003,2003,1,-119.169972,45.845889,"field  conductivity"
"5945",16036,11,2001,2012,62,-119.221,45.8344,"field  conductivity"
"5946",16037,11,2001,2012,62,-119.2252,45.7856,"field  conductivity"
"5947",16038,11,2001,2012,66,-119.2168,45.7865,"field  conductivity"
"5948",16046,11,2001,2012,67,-119.1537,45.8248,"field  conductivity"
"5949",16047,0,2009,2009,1,-119.244611,45.885361,"field  conductivity"
"5950",16048,3,2001,2004,19,-119.3098,45.7946,"field  conductivity"
"5951",16049,0,2003,2003,1,-119.490833,45.8975,"field  conductivity"
"5952",16053,0,2003,2003,1,-119.368333,45.835278,"field  conductivity"
"5953",16055,6,2003,2009,2,-119.163889,45.917778,"field  conductivity"
"5954",16056,1,2001,2002,6,-119.1711,45.9106,"field  conductivity"
"5955",16063,6,2003,2009,2,-119.3325,45.812778,"field  conductivity"
"5956",16068,0,2003,2003,1,-119.350833,45.825278,"field  conductivity"
"5957",16069,6,2003,2009,2,-119.368889,45.783333,"field  conductivity"
"5958",16070,6,2003,2009,2,-119.328333,45.785556,"field  conductivity"
"5959",16072,6,2003,2009,3,-119.281111,45.824444,"field  conductivity"
"5960",16074,11,2001,2012,54,-119.3209,45.8132,"field  conductivity"
"5961",16075,6,2001,2007,27,-119.6429,45.8288,"field  conductivity"
"5962",16076,6,2003,2009,3,-119.690833,45.844444,"field  conductivity"
"5963",16078,1,2001,2002,7,NA,NA,"field  conductivity"
"5964",16079,0,2009,2009,1,-119.314167,45.819167,"field  conductivity"
"5965",16084,11,2001,2012,58,-119.353,45.8291,"field  conductivity"
"5966",16086,11,2001,2012,63,-119.3817,45.9132,"field  conductivity"
"5967",16091,0,2003,2003,1,-119.252778,45.816944,"field  conductivity"
"5968",16093,11,2001,2012,66,-119.4396,45.9055,"field  conductivity"
"5969",16096,11,2001,2012,64,-119.1896,45.8637,"field  conductivity"
"5970",16099,11,2001,2012,67,-119.2194,45.8865,"field  conductivity"
"5971",16100,11,2001,2012,65,-119.1641,45.8467,"field  conductivity"
"5972",16102,11,2001,2012,67,-119.3884,45.7707,"field  conductivity"
"5973",16106,11,2001,2012,64,-119.2115,45.8647,"field  conductivity"
"5974",16109,11,2001,2012,69,-119.3151,45.8232,"field  conductivity"
"5975",16112,4,2001,2005,24,-119.3268,45.7903,"field  conductivity"
"5976",16113,6,2003,2009,2,-119.325556,45.784722,"field  conductivity"
"5977",16114,0,2009,2009,2,-119.262778,45.820278,"field  conductivity"
"5978",16122,6,2003,2009,2,-119.351944,45.843333,"field  conductivity"
"5979",16123,11,2001,2012,62,-119.4351,45.7736,"field  conductivity"
"5980",16126,0,2009,2009,1,-119.372778,45.821944,"field  conductivity"
"5981",16128,6,2003,2009,2,-119.351667,45.848889,"field  conductivity"
"5982",16134,11,2001,2012,58,-119.5065,45.8863,"field  conductivity"
"5983",16146,11,2001,2012,70,-119.2396,45.8358,"field  conductivity"
"5984",16150,11,2001,2012,57,-119.5597,45.8658,"field  conductivity"
"5985",16151,0,2009,2009,2,-119.553333,45.888889,"field  conductivity"
"5986",16153,0,2009,2009,1,-119.566944,45.918889,"field  conductivity"
"5987",16154,10,2002,2012,58,-119.5067,45.8988,"field  conductivity"
"5988",16158,11,2001,2012,62,-119.4756,45.8065,"field  conductivity"
"5989",16164,0,2009,2009,1,-119.589167,45.876389,"field  conductivity"
"5990",16167,0,2009,2009,1,-119.64,45.848889,"field  conductivity"
"5991",16170,11,2001,2012,64,-119.5102,45.8747,"field  conductivity"
"5992",16175,11,2001,2012,59,-119.343,45.7476,"field  conductivity"
"5993",16176,0,2009,2009,1,-119.396111,45.71,"field  conductivity"
"5994",16177,11,2001,2012,63,-119.3733,45.6978,"field  conductivity"
"5995",16180,11,2001,2012,62,-119.1966,45.7317,"field  conductivity"
"5996",16181,11,2001,2012,69,-119.2105,45.7586,"field  conductivity"
"5997",16182,0,2009,2009,1,-119.240556,45.747778,"field  conductivity"
"5998",16184,0,2009,2009,1,-119.540278,45.776389,"field  conductivity"
"5999",16188,11,2001,2012,66,-119.3728,45.8463,"field  conductivity"
"6000",16191,11,2001,2012,63,-119.6539,45.8509,"field  conductivity"
"6001",16192,0,2003,2003,1,-119.494361,45.852472,"field  conductivity"
"6002",16193,0,2003,2003,1,-119.501083,45.847306,"field  conductivity"
"6003",16194,0,2003,2003,1,-119.506639,45.859083,"field  conductivity"
"6004",16195,0,2003,2003,1,-119.499278,45.854722,"field  conductivity"
"6005",16196,0,2003,2003,1,-119.496972,45.832389,"field  conductivity"
"6006",16198,0,2009,2009,1,-119.398139,45.852972,"field  conductivity"
"6007",16203,0,2003,2003,1,-119.495611,45.85875,"field  conductivity"
"6008",16204,0,2003,2003,1,-119.506722,45.84575,"field  conductivity"
"6009",16205,0,2003,2003,1,-119.503722,45.841,"field  conductivity"
"6010",16207,0,2003,2003,1,-119.497389,45.843972,"field  conductivity"
"6011",16208,7,2003,2010,2,-119.453083,45.851944,"field  conductivity"
"6012",16209,0,2009,2009,1,-119.389944,45.8495,"field  conductivity"
"6013",16212,0,2009,2009,1,-119.397056,45.846083,"field  conductivity"
"6014",16214,7,2003,2010,3,-119.428472,45.828583,"field  conductivity"
"6015",16215,7,2003,2010,2,-119.428639,45.828639,"field  conductivity"
"6016",16218,7,2003,2010,2,-119.438278,45.837306,"field  conductivity"
"6017",16221,0,2009,2009,1,-119.602278,45.858361,"field  conductivity"
"6018",16222,0,2009,2009,1,-119.620583,45.848278,"field  conductivity"
"6019",16223,0,2009,2009,1,-119.623583,45.807,"field  conductivity"
"6020",16224,0,2009,2009,1,-119.380472,45.858,"field  conductivity"
"6021",16225,0,2009,2009,1,-119.372139,45.864,"field  conductivity"
"6022",16226,0,2009,2009,1,-119.357778,45.858306,"field  conductivity"
"6023",16227,0,2009,2009,1,-119.359806,45.858278,"field  conductivity"
"6024",16228,0,2009,2009,2,-119.378694,45.857972,"field  conductivity"
"6025",16229,0,2009,2009,1,-119.383139,45.769639,"field  conductivity"
"6026",16230,0,2009,2009,1,-119.439139,45.748167,"field  conductivity"
"6027",16231,0,2009,2009,1,-119.407139,45.730306,"field  conductivity"
"6028",16232,0,2009,2009,1,-119.347833,45.740917,"field  conductivity"
"6029",16233,0,2009,2009,1,-119.358056,45.864083,"field  conductivity"
"6030",16234,0,2009,2009,1,-119.232611,45.780722,"field  conductivity"
"6031",16237,0,2010,2010,1,-119.315167,45.792972,"field  conductivity"
"6032",16238,0,2010,2010,1,-119.287139,45.791944,"field  conductivity"
"6033",16242,0,2010,2010,1,-119.32175,45.773611,"field  conductivity"
"6034",16245,0,2010,2010,1,-119.351444,45.759278,"field  conductivity"
"6035",16248,0,2010,2010,1,-119.293472,45.794167,"field  conductivity"
"6036",16249,0,2009,2009,1,-119.232583,45.781,"field  conductivity"
"6037",16250,0,2009,2009,1,-119.226333,45.782806,"field  conductivity"
"6038",16252,0,2009,2009,1,-119.226583,45.782861,"field  conductivity"
"6039",16253,0,2003,2003,1,-119.225083,45.806333,"field  conductivity"
"6040",16254,0,2003,2003,2,-119.235694,45.82025,"field  conductivity"
"6041",16255,0,2003,2003,1,-119.224694,45.820056,"field  conductivity"
"6042",16256,7,2003,2010,2,-119.473528,45.897889,"field  conductivity"
"6043",16257,7,2003,2010,3,-119.474639,45.898944,"field  conductivity"
"6044",16258,7,2003,2010,2,-119.475972,45.900028,"field  conductivity"
"6045",16261,0,2010,2010,1,-119.870833,45.704333,"field  conductivity"
"6046",16262,0,2010,2010,1,-119.819778,45.698944,"field  conductivity"
"6047",16263,0,2010,2010,2,-119.833306,45.720694,"field  conductivity"
"6048",16264,0,2010,2010,1,-119.866194,45.795611,"field  conductivity"
"6049",16266,0,2003,2003,1,-119.494833,45.836389,"field  conductivity"
"6050",16269,0,2003,2003,1,-119.22,45.882222,"field  conductivity"
"6051",16272,5,2003,2008,2,-124.0715,44.3995,"field  conductivity"
"6052",16273,5,2003,2008,2,-124.0711,44.4013,"field  conductivity"
"6053",16275,5,2003,2008,3,-124.0711,44.3999,"field  conductivity"
"6054",16276,5,2003,2008,2,-124.0709,44.3999,"field  conductivity"
"6055",16278,5,2003,2008,2,-124.071,44.3998,"field  conductivity"
"6056",16280,5,2003,2008,3,-124.0686,44.4024,"field  conductivity"
"6057",16534,0,2009,2009,1,-123.221111,44.233611,"field  conductivity"
"6058",16536,0,2009,2009,1,-123.203889,44.239167,"field  conductivity"
"6059",16537,7,2002,2009,4,-123.219444,44.25,"field  conductivity"
"6060",16543,0,2009,2009,1,-123.176389,44.222222,"field  conductivity"
"6061",16545,7,2002,2009,4,-123.245,44.25249,"field  conductivity"
"6062",16553,7,2002,2009,5,-123.18777,44.207779,"field  conductivity"
"6063",16591,0,2009,2009,1,-122.991667,44.590556,"field  conductivity"
"6064",16649,0,2009,2009,1,-123.12355,44.18477,"field  conductivity"
"6065",16650,0,2009,2009,1,-123.12949,44.18862,"field  conductivity"
"6066",16655,0,2009,2009,1,-123.12239,44.18861,"field  conductivity"
"6067",16656,4,2002,2006,3,-123.0744,44.13537,"field  conductivity"
"6068",16658,7,2002,2009,3,-123.0946,44.13508,"field  conductivity"
"6069",16660,7,2002,2009,5,-123.0974,44.14236,"field  conductivity"
"6070",16677,0,2001,2001,1,-122.856389,45.174167,"field  conductivity"
"6071",16696,0,2001,2001,1,-122.859167,45.178611,"field  conductivity"
"6072",16697,7,2003,2010,4,-122.855556,45.178056,"field  conductivity"
"6073",16699,0,2001,2001,1,-122.859083,45.173389,"field  conductivity"
"6074",16701,9,2001,2010,5,-122.860556,45.179444,"field  conductivity"
"6075",16705,0,2010,2010,1,-122.856389,45.180833,"field  conductivity"
"6076",16708,0,2001,2001,1,-122.858889,45.174444,"field  conductivity"
"6077",16709,0,2001,2001,1,-122.858056,45.173333,"field  conductivity"
"6078",16718,0,2011,2011,2,-122.7325,42.263611,"field  conductivity"
"6079",16719,0,2011,2011,1,-122.736389,42.262778,"field  conductivity"
"6080",16721,0,2011,2011,1,-122.736111,42.261389,"field  conductivity"
"6081",16727,7,2002,2009,4,-124.318333,43.209167,"field  conductivity"
"6082",16732,3,2003,2006,2,-123.112778,44.098333,"field  conductivity"
"6083",16733,3,2003,2006,2,-123.106667,44.1075,"field  conductivity"
"6084",16734,3,2003,2006,2,-123.106111,44.107778,"field  conductivity"
"6085",16737,3,2003,2006,3,-123.108611,44.104167,"field  conductivity"
"6086",16738,3,2003,2006,3,-123.111111,44.100556,"field  conductivity"
"6087",16739,3,2006,2009,2,-122.771111,42.383333,"field  conductivity"
"6088",16740,3,2003,2006,2,-122.771389,42.383611,"field  conductivity"
"6089",16741,0,2006,2006,1,-122.772222,42.383333,"field  conductivity"
"6090",16742,0,2007,2007,1,-123.3382,43.3371,"field  conductivity"
"6091",16743,0,2007,2007,1,-123.337778,43.335833,"field  conductivity"
"6092",16754,7,2002,2009,4,-124.297222,43.318333,"field  conductivity"
"6093",16756,0,2002,2002,1,-124.298333,43.318889,"field  conductivity"
"6094",16757,0,2003,2003,2,-123.624722,42.213611,"field  conductivity"
"6095",16758,0,2003,2003,1,-123.625,42.215556,"field  conductivity"
"6096",16759,9,2002,2011,6,-121.747778,42.236111,"field  conductivity"
"6097",16760,9,2002,2011,6,-121.747778,42.233056,"field  conductivity"
"6098",16761,9,2002,2011,6,-121.751667,42.2325,"field  conductivity"
"6099",16762,9,2002,2011,7,-121.754722,42.232222,"field  conductivity"
"6100",16772,6,2003,2009,2,-122.952778,42.305556,"field  conductivity"
"6101",16997,0,2005,2005,2,-120.860444,44.301972,"field  conductivity"
"6102",17132,4,2001,2005,6,-124.1205,43.423083,"field  conductivity"
"6103",17164,0,2002,2002,2,-122.857361,42.963389,"field  conductivity"
"6104",18741,5,2006,2011,59,-122.659722,45.41,"field  conductivity"
"6105",18742,5,2006,2011,55,-122.662722,45.465278,"field  conductivity"
"6106",18774,0,2001,2001,1,-124.105528,44.265667,"field  conductivity"
"6107",18775,0,2001,2001,1,-123.845472,44.319833,"field  conductivity"
"6108",18789,0,2002,2002,1,-123.611389,42.80375,"field  conductivity"
"6109",18790,0,2002,2002,1,-123.588667,42.817667,"field  conductivity"
"6110",18796,0,2001,2001,1,-123.7928,44.7456,"field  conductivity"
"6111",18797,2,2001,2003,16,-123.9003,45.1404,"field  conductivity"
"6112",18802,0,2001,2001,8,-123.769111,45.813472,"field  conductivity"
"6113",18803,0,2001,2001,2,-123.765083,43.806222,"field  conductivity"
"6114",18804,6,2001,2007,9,-124.10825,44.224194,"field  conductivity"
"6115",18821,5,2003,2008,9,-124.427583,42.965917,"field  conductivity"
"6116",18822,5,2003,2008,11,-124.414333,43.003361,"field  conductivity"
"6117",18823,5,2003,2008,12,-124.41375,43.052083,"field  conductivity"
"6118",18824,4,2003,2007,4,-124.423417,42.975472,"field  conductivity"
"6119",18826,0,2005,2005,2,-124.221806,43.433611,"field  conductivity"
"6120",18827,0,2005,2005,2,-124.214972,43.4325,"field  conductivity"
"6121",18828,0,2005,2005,2,-124.199667,43.416222,"field  conductivity"
"6122",18829,2,2005,2007,3,-124.203139,43.405417,"field  conductivity"
"6123",20389,0,2001,2001,3,-123.779472,45.827167,"field  conductivity"
"6124",20391,0,2005,2005,1,-124.067333,42.8885,"field  conductivity"
"6125",20392,4,2001,2005,10,-124.06725,42.88875,"field  conductivity"
"6126",20394,6,2005,2011,8,-124.067417,42.888111,"field  conductivity"
"6127",20422,6,2002,2008,3,-119.308333,45.886111,"field  conductivity"
"6128",20423,6,2002,2008,6,-119.305278,45.886111,"field  conductivity"
"6129",20424,6,2002,2008,3,-119.309722,45.89,"field  conductivity"
"6130",20440,0,2001,2001,8,-123.845556,45.695306,"field  conductivity"
"6131",20447,4,2005,2009,28,-124.096472,43.595028,"field  conductivity"
"6132",20835,0,2003,2003,2,-123.142611,44.054389,"field  conductivity"
"6133",20846,0,2003,2003,1,-123.134306,44.059944,"field  conductivity"
"6134",21506,0,2002,2002,2,-122.551833,42.997944,"field  conductivity"
"6135",21535,1,2011,2012,6,-121.500333,42.462,"field  conductivity"
"6136",21790,0,2002,2002,2,-123.979761,44.499656,"field  conductivity"
"6137",21791,5,2002,2007,6,-124.105811,44.170708,"field  conductivity"
"6138",21792,0,2003,2003,2,-123.92875,44.580669,"field  conductivity"
"6139",21794,3,2002,2005,3,-124.305169,42.804089,"field  conductivity"
"6140",21797,2,2003,2005,2,-124.185911,42.974633,"field  conductivity"
"6141",21799,0,2002,2002,1,-124.029111,42.768633,"field  conductivity"
"6142",21800,0,2011,2011,7,-123.55045,45.277942,"field  conductivity"
"6143",21804,3,2002,2005,3,-123.621869,45.228936,"field  conductivity"
"6144",21805,3,2002,2005,4,-123.830931,45.351989,"field  conductivity"
"6145",21806,0,2002,2002,1,-123.822639,45.284822,"field  conductivity"
"6146",21807,0,2002,2002,2,-123.8835,45.912014,"field  conductivity"
"6147",21811,3,2002,2005,5,-123.51585,45.585806,"field  conductivity"
"6148",21812,0,2002,2002,1,-123.490039,45.552708,"field  conductivity"
"6149",21813,0,2002,2002,2,-123.284581,45.736719,"field  conductivity"
"6150",21814,4,2001,2005,2,-123.91125,42.174153,"field  conductivity"
"6151",21822,3,2002,2005,5,-123.238861,42.101917,"field  conductivity"
"6152",21832,0,2002,2002,2,-122.251917,44.437386,"field  conductivity"
"6153",21833,0,2002,2002,1,-122.736606,44.258794,"field  conductivity"
"6154",21835,4,2001,2005,5,-122.101831,44.782844,"field  conductivity"
"6155",21839,3,2002,2005,5,-122.889283,43.740583,"field  conductivity"
"6156",21841,0,2002,2002,1,-123.125125,45.508128,"field  conductivity"
"6157",21842,1,2007,2008,3,-123.851073,44.538726,"field  conductivity"
"6158",21848,0,2007,2007,1,-123.979692,42.045169,"field  conductivity"
"6159",21849,0,2007,2007,1,-124.034286,42.573014,"field  conductivity"
"6160",21877,0,2008,2008,3,-121.7812,45.464478,"field  conductivity"
"6161",22369,9,2002,2011,58,-123.706519,45.277064,"field  conductivity"
"6162",22375,0,2011,2011,6,-123.603114,45.239361,"field  conductivity"
"6163",22383,0,2011,2011,7,-123.580667,45.265833,"field  conductivity"
"6164",22386,0,2008,2008,1,-123.168453,45.436233,"field  conductivity"
"6165",22394,9,2002,2011,61,-123.818167,45.2765,"field  conductivity"
"6166",22569,2,2001,2003,12,-121.464178,43.824022,"field  conductivity"
"6167",22571,0,2002,2002,1,-121.464156,43.824003,"field  conductivity"
"6168",22572,2,2001,2003,19,-121.464147,43.823897,"field  conductivity"
"6169",22573,2,2001,2003,10,-121.464156,43.823744,"field  conductivity"
"6170",22574,2,2001,2003,9,-121.464642,43.823903,"field  conductivity"
"6171",22651,5,2001,2006,32,-122.7605,44.254167,"field  conductivity"
"6172",22654,5,2001,2006,32,-122.854083,44.172861,"field  conductivity"
"6173",22667,0,2002,2002,1,-124.243419,43.436939,"field  conductivity"
"6174",22668,0,2002,2002,1,-124.238749,43.43694,"field  conductivity"
"6175",22669,0,2002,2002,1,-124.244882,43.436594,"field  conductivity"
"6176",22670,0,2002,2002,1,-124.243561,43.436594,"field  conductivity"
"6177",22671,0,2002,2002,1,-124.240966,43.436422,"field  conductivity"
"6178",22672,4,2002,2006,2,-124.241013,43.436491,"field  conductivity"
"6179",22673,0,2002,2002,1,-124.24587,43.434834,"field  conductivity"
"6180",22674,4,2002,2006,2,-124.244879,43.434282,"field  conductivity"
"6181",22675,4,2002,2006,4,-124.243888,43.434351,"field  conductivity"
"6182",22676,0,2004,2004,1,-123.426725,43.103019,"field  conductivity"
"6183",22677,0,2004,2004,1,-123.426539,43.100265,"field  conductivity"
"6184",22678,0,2004,2004,1,-123.426539,43.098648,"field  conductivity"
"6185",22679,0,2004,2004,1,-123.426304,43.099508,"field  conductivity"
"6186",22680,0,2004,2004,1,-123.426256,43.102881,"field  conductivity"
"6187",22681,5,2005,2010,4,-120.254125,45.621565,"field  conductivity"
"6188",22683,0,2002,2002,1,-122.744444,45.612222,"field  conductivity"
"6189",22684,5,2005,2010,3,-121.136719,45.560133,"field  conductivity"
"6190",22685,5,2005,2010,3,-121.138153,45.563756,"field  conductivity"
"6191",22687,2,2005,2007,2,-121.130381,45.561053,"field  conductivity"
"6192",22689,2,2005,2007,3,-121.141683,45.561742,"field  conductivity"
"6193",22691,0,2010,2010,2,-121.141272,45.565861,"field  conductivity"
"6194",22692,6,2005,2011,2,-122.699583,45.593611,"field  conductivity"
"6195",22696,6,2006,2012,3,-118.475833,45.9575,"field  conductivity"
"6196",22697,6,2006,2012,4,-118.480833,45.961667,"field  conductivity"
"6197",22698,6,2006,2012,5,-118.483333,45.958056,"field  conductivity"
"6198",22699,4,2002,2006,3,-121.251389,44.010556,"field  conductivity"
"6199",22700,9,2002,2011,2,-121.258889,44.010278,"field  conductivity"
"6200",22701,5,2006,2011,4,-121.446111,43.782778,"field  conductivity"
"6201",22702,5,2006,2011,4,-121.445,43.781667,"field  conductivity"
"6202",22705,5,2006,2011,3,-121.444722,43.782222,"field  conductivity"
"6203",22715,0,2002,2002,1,-122.995,44.900278,"field  conductivity"
"6204",22716,7,2002,2009,4,-122.998056,44.901389,"field  conductivity"
"6205",22719,7,2002,2009,4,-122.993889,44.897222,"field  conductivity"
"6206",22721,6,2003,2009,3,-122.770278,42.386111,"field  conductivity"
"6207",22954,0,2001,2001,2,-123.231222,46.128944,"field  conductivity"
"6208",22965,0,2005,2005,2,-121.495472,45.651611,"field  conductivity"
"6209",22966,0,2005,2005,1,-121.495667,45.651639,"field  conductivity"
"6210",22970,0,2005,2005,2,-121.543528,45.635028,"field  conductivity"
"6211",22971,0,2005,2005,1,-121.534306,45.628639,"field  conductivity"
"6212",22972,0,2005,2005,2,-121.530056,45.627278,"field  conductivity"
"6213",22973,0,2005,2005,2,-121.529611,45.627278,"field  conductivity"
"6214",22974,0,2005,2005,2,-121.528,45.627278,"field  conductivity"
"6215",22978,0,2005,2005,2,-121.518778,45.638889,"field  conductivity"
"6216",22985,0,2005,2005,1,-118.84027,45.668152,"field  conductivity"
"6217",22986,0,2005,2005,1,-118.84195,45.66786,"field  conductivity"
"6218",23026,0,2005,2005,1,-117.913528,45.577083,"field  conductivity"
"6219",23038,0,2005,2005,1,-118.83934,45.66825,"field  conductivity"
"6220",23070,6,2002,2008,57,-122.851722,42.318083,"field  conductivity"
"6221",23160,4,2004,2008,2,-123.098056,43.303056,"field  conductivity"
"6222",23161,4,2004,2008,3,-123.100556,43.303056,"field  conductivity"
"6223",23162,4,2004,2008,3,-123.100556,43.305,"field  conductivity"
"6224",23163,4,2004,2008,2,-123.099444,43.305556,"field  conductivity"
"6225",23172,3,2001,2004,5,-122.86916,45.181111,"field  conductivity"
"6226",23176,1,2003,2004,2,-122.86,45.181667,"field  conductivity"
"6227",23195,11,2001,2012,59,-116.995,44.198333,"field  conductivity"
"6228",23196,2,2006,2008,2,-118.116667,45.3525,"field  conductivity"
"6229",23197,6,2002,2008,3,-118.121667,45.348333,"field  conductivity"
"6230",23198,6,2002,2008,5,-118.121944,45.347778,"field  conductivity"
"6231",23202,0,2002,2002,1,-118.121806,45.347917,"field  conductivity"
"6232",23242,0,2001,2001,2,-123.95,44.020833,"field  conductivity"
"6233",23243,0,2003,2003,16,-123.9377,45.1612,"field  conductivity"
"6234",23260,4,2007,2011,3,-123.39694,42.498055,"field  conductivity"
"6235",23296,0,2005,2005,20,-123.4348096,45.8215724,"field  conductivity"
"6236",23317,0,2001,2001,1,-118.8034,45.665,"field  conductivity"
"6237",23318,0,2001,2001,1,-118.8037,45.665,"field  conductivity"
"6238",23319,0,2001,2001,1,-118.8038,45.6652,"field  conductivity"
"6239",23320,0,2001,2001,1,-118.8035,45.6652,"field  conductivity"
"6240",23321,0,2011,2011,1,-121.55307,43.68474,"field  conductivity"
"6241",23402,1,2002,2003,2,-123.999406,42.454753,"field  conductivity"
"6242",23408,0,2002,2002,2,-124.037414,42.514094,"field  conductivity"
"6243",23438,0,2011,2011,1,-121.4952778,43.700833,"field  conductivity"
"6244",23443,0,2011,2011,1,-121.4653,43.86283,"field  conductivity"
"6245",23445,0,2011,2011,1,-121.47556,43.70802,"field  conductivity"
"6246",23487,5,2005,2010,32,-118.165106,45.829289,"field  conductivity"
"6247",23492,5,2005,2010,34,-118.333181,45.900972,"field  conductivity"
"6248",23497,0,2011,2011,3,-118.378722,46,"field  conductivity"
"6249",23509,11,2001,2012,9,-123.589979,45.84384,"field  conductivity"
"6250",23523,0,2001,2001,2,-123.375643,46.132539,"field  conductivity"
"6251",23538,0,2001,2001,2,-123.081763,46.041327,"field  conductivity"
"6252",23539,0,2001,2001,3,-123.038425,45.988468,"field  conductivity"
"6253",23737,11,2001,2012,60,-116.99405,44.242883,"field  conductivity"
"6254",23738,1,2001,2002,7,-122.648483,42.439617,"field  conductivity"
"6255",23744,7,2002,2009,86,-124.033975,44.294306,"field  conductivity"
"6256",23745,7,2002,2009,79,-123.973897,44.297889,"field  conductivity"
"6257",23746,7,2002,2009,79,-123.97686,44.296922,"field  conductivity"
"6258",23747,7,2002,2009,81,-123.976861,44.316914,"field  conductivity"
"6259",23748,7,2002,2009,79,-123.974386,44.316914,"field  conductivity"
"6260",23749,7,2002,2009,81,-123.939722,44.288694,"field  conductivity"
"6261",23750,7,2002,2009,60,-123.96171,44.277481,"field  conductivity"
"6262",23751,7,2002,2009,81,-123.960472,44.277514,"field  conductivity"
"6263",23752,6,2003,2009,69,-124.027139,44.296789,"field  conductivity"
"6264",23753,6,2003,2009,33,-124.407222,42.371944,"field  conductivity"
"6265",23758,5,2001,2006,15,-123.460747,42.39476,"field  conductivity"
"6266",23759,5,2001,2006,12,-123.538817,42.363161,"field  conductivity"
"6267",23760,5,2001,2006,15,-123.579786,42.363942,"field  conductivity"
"6268",23761,5,2003,2008,15,-124.494653,42.764017,"field  conductivity"
"6269",23764,1,2001,2002,26,-122.687853,42.459283,"field  conductivity"
"6270",23765,0,2002,2002,2,-122.811075,42.537853,"field  conductivity"
"6271",23793,1,2004,2005,8,-122.02835,45.614216,"field  conductivity"
"6272",23797,2,2001,2003,13,-122.826317,45.970117,"field  conductivity"
"6273",23800,2,2001,2003,14,-123.4242,46.220683,"field  conductivity"
"6274",23810,2,2006,2008,17,-122.611817,45.602366,"field  conductivity"
"6275",23812,0,2008,2008,2,-122.60665,45.60793,"field  conductivity"
"6276",23815,0,2003,2003,1,-123.846842,45.897376,"field  conductivity"
"6277",23816,0,2003,2003,1,-123.754676,45.545668,"field  conductivity"
"6278",23819,0,2003,2003,1,-123.488,45.4743,"field  conductivity"
"6279",23821,0,2003,2003,1,-123.68697,44.197048,"field  conductivity"
"6280",23823,0,2003,2003,1,-123.9838,44.085856,"field  conductivity"
"6281",23836,3,2002,2005,4,-123.39559,42.781741,"field  conductivity"
"6282",23837,2,2003,2005,3,-123.60948,43.45645,"field  conductivity"
"6283",23839,0,2003,2003,1,-123.20991,42.602606,"field  conductivity"
"6284",23840,0,2007,2007,2,-123.5701,42.655431,"field  conductivity"
"6285",23843,0,2007,2007,1,-123.23909,42.07499,"field  conductivity"
"6286",23847,4,2001,2005,4,-122.3852,44.427415,"field  conductivity"
"6287",23849,0,2003,2003,2,-122.28915,44.852973,"field  conductivity"
"6288",23851,0,2001,2001,2,-121.999052,44.57005,"field  conductivity"
"6289",23853,0,2003,2003,1,-123.350797,45.173487,"field  conductivity"
"6290",23854,0,2003,2003,1,-123.55147,45.000534,"field  conductivity"
"6291",23857,0,2003,2003,1,-122.677977,43.620848,"field  conductivity"
"6292",23859,2,2001,2003,26,-123.393163,44.265533,"field  conductivity"
"6293",23863,0,2007,2007,2,-123.311606,44.415841,"field  conductivity"
"6294",23864,0,2006,2006,1,-122.795884,44.966953,"field  conductivity"
"6295",23870,3,2001,2004,15,-123.065739,42.230231,"field  conductivity"
"6296",23873,0,2001,2001,4,-123.366286,45.98023,"field  conductivity"
"6297",23892,2,2005,2007,19,-122.99812,43.32422,"field  conductivity"
"6298",23897,2,2005,2007,20,-122.54524,43.29207,"field  conductivity"
"6299",23930,1,2006,2007,3,-124.498122,42.91153,"field  conductivity"
"6300",23931,1,2006,2007,4,-124.49281,42.91442,"field  conductivity"
"6301",23934,0,2001,2001,4,-123.003313,45.899925,"field  conductivity"
"6302",23958,3,2007,2010,14,-124.04154,43.25863,"field  conductivity"
"6303",23959,9,2001,2010,24,-124.00586,43.27088,"field  conductivity"
"6304",23961,9,2001,2010,23,-124.02177,43.29058,"field  conductivity"
"6305",23980,9,2001,2010,25,-124.09378,43.1865,"field  conductivity"
"6306",24037,0,2003,2003,5,-123.918611,46.128611,"field  conductivity"
"6307",24090,5,2003,2008,8,-124.31929,42.94343,"field  conductivity"
"6308",24091,5,2003,2008,10,-124.3339,42.94921,"field  conductivity"
"6309",24174,0,2003,2003,1,-123.9071,46.0851,"field  conductivity"
"6310",24295,0,2003,2003,1,-123.90767,46.09176,"field  conductivity"
"6311",24297,0,2001,2001,6,-123.863198,45.731672,"field  conductivity"
"6312",24299,0,2001,2001,4,-123.201595,45.843657,"field  conductivity"
"6313",24300,0,2001,2001,4,-123.154787,45.899615,"field  conductivity"
"6314",24302,1,2007,2008,12,-121.50892,44.32117,"field  conductivity"
"6315",24303,1,2007,2008,18,-121.38515,44.41979,"field  conductivity"
"6316",24317,1,2007,2008,14,-121.54399,44.28799,"field  conductivity"
"6317",24318,1,2007,2008,10,-121.56712,44.23359,"field  conductivity"
"6318",24326,0,2002,2002,3,-123.9115,46.0107,"field  conductivity"
"6319",24341,11,2001,2012,57,-117.0573,43.795233,"field  conductivity"
"6320",24344,0,2005,2005,1,NA,NA,"field  conductivity"
"6321",24349,0,2003,2003,1,-123.91404,46.0957,"field  conductivity"
"6322",24364,2,2001,2003,10,-121.493611,43.700556,"field  conductivity"
"6323",24365,0,2002,2002,1,-121.493611,43.707222,"field  conductivity"
"6324",24366,2,2001,2003,9,-121.498333,43.706389,"field  conductivity"
"6325",24367,0,2002,2002,1,-121.485556,43.704444,"field  conductivity"
"6326",24368,2,2001,2003,9,-121.496667,43.710556,"field  conductivity"
"6327",24369,2,2001,2003,9,-121.498056,43.713611,"field  conductivity"
"6328",24370,1,2002,2003,7,-121.465278,43.706389,"field  conductivity"
"6329",24371,1,2002,2003,7,-121.460278,43.706389,"field  conductivity"
"6330",24372,1,2002,2003,8,-121.460833,43.791667,"field  conductivity"
"6331",24373,2,2001,2003,9,-121.464583,43.792833,"field  conductivity"
"6332",24374,2,2001,2003,7,-121.464583,43.792389,"field  conductivity"
"6333",24375,2,2001,2003,9,-121.463972,43.792694,"field  conductivity"
"6334",24376,2,2001,2003,12,-121.458611,43.798611,"field  conductivity"
"6335",24377,2,2001,2003,9,-121.458611,43.799722,"field  conductivity"
"6336",24378,1,2001,2002,2,-121.456944,43.801944,"field  conductivity"
"6337",24379,0,2003,2003,4,-121.83316,43.82444,"field  conductivity"
"6338",24380,2,2001,2003,9,-121.459543,43.831395,"field  conductivity"
"6339",24381,1,2001,2002,2,-121.459194,43.830616,"field  conductivity"
"6340",24382,2,2001,2003,22,-121.464052,43.792862,"field  conductivity"
"6341",24388,0,2001,2001,7,-123.8804,45.7012,"field  conductivity"
"6342",24391,0,2005,2005,1,-122.86306,45.84076,"field  conductivity"
"6343",24409,1,2001,2002,11,-122.783508,42.440414,"field  conductivity"
"6344",24411,0,2002,2002,3,-122.849844,42.681817,"field  conductivity"
"6345",24450,1,2001,2002,3,-122.683228,42.761358,"field  conductivity"
"6346",24451,0,2002,2002,23,-122.690306,42.655872,"field  conductivity"
"6347",24457,1,2001,2002,2,-122.753197,42.663548,"field  conductivity"
"6348",24488,5,2002,2007,4,-123.93222,44.60538,"field  conductivity"
"6349",24489,9,2002,2011,5,-123.93369,44.60559,"field  conductivity"
"6350",24490,2,2002,2004,2,-123.92893,44.60188,"field  conductivity"
"6351",24491,0,2002,2002,1,-123.9316,44.6049,"field  conductivity"
"6352",24492,9,2002,2011,5,-123.92233,44.60043,"field  conductivity"
"6353",24501,2,2001,2003,7,-121.53731,43.69052,"field  conductivity"
"6354",24503,1,2001,2002,2,-121.47607,43.70743,"field  conductivity"
"6355",24504,2,2001,2003,10,-121.47622,43.70785,"field  conductivity"
"6356",24505,2,2001,2003,10,-121.47728,43.70758,"field  conductivity"
"6357",24506,2,2001,2003,8,-121.51961,43.70975,"field  conductivity"
"6358",24508,0,2002,2002,2,-121.51908,43.71014,"field  conductivity"
"6359",24509,2,2001,2003,8,-121.51677,43.7125,"field  conductivity"
"6360",24510,2,2001,2003,8,-121.51719,43.71291,"field  conductivity"
"6361",24511,2,2001,2003,8,-121.516065,43.712903,"field  conductivity"
"6362",24512,3,2001,2004,9,-121.50083,43.71306,"field  conductivity"
"6363",24513,3,2001,2004,9,-121.50056,43.71333,"field  conductivity"
"6364",24517,2,2001,2003,10,-121.50023,43.74202,"field  conductivity"
"6365",24518,2,2001,2003,8,-121.50044,43.74362,"field  conductivity"
"6366",24519,2,2001,2003,10,-121.49929,43.74364,"field  conductivity"
"6367",24548,5,2005,2010,3,-121.13755,45.56747,"field  conductivity"
"6368",24561,0,2009,2009,1,-123.37976,43.18707,"field  conductivity"
"6369",24562,0,2009,2009,1,-123.37969,43.18703,"field  conductivity"
"6370",24570,1,2002,2003,55,-123.966667,45.088611,"field  conductivity"
"6371",24576,1,2002,2003,8,-121.48088,43.83669,"field  conductivity"
"6372",24578,2,2001,2003,13,-121.494631,43.730308,"field  conductivity"
"6373",24580,2,2001,2003,17,-121.494496,43.730231,"field  conductivity"
"6374",24581,2,2001,2003,14,-121.494503,43.730204,"field  conductivity"
"6375",24582,2,2001,2003,11,-121.464119,43.792859,"field  conductivity"
"6376",24585,2,2001,2003,13,-121.463913,43.792493,"field  conductivity"
"6377",24586,2,2001,2003,18,-121.463982,43.793019,"field  conductivity"
"6378",24590,0,2009,2009,2,-123.16316,44.33209,"field  conductivity"
"6379",24592,7,2002,2009,3,-123.12846,44.3158,"field  conductivity"
"6380",24597,2,2001,2003,18,-121.459773,43.794534,"field  conductivity"
"6381",24598,2,2001,2003,12,-121.459472,43.794677,"field  conductivity"
"6382",24599,2,2001,2003,13,-121.465437,43.821942,"field  conductivity"
"6383",24600,2,2001,2003,17,-121.465284,43.821938,"field  conductivity"
"6384",24601,2,2001,2003,13,-121.465281,43.821642,"field  conductivity"
"6385",24604,4,2002,2006,2,-122.92536,44.61331,"field  conductivity"
"6386",24607,2,2001,2003,22,-121.521171,43.70068,"field  conductivity"
"6387",24608,2,2001,2003,17,-121.477183,43.707738,"field  conductivity"
"6388",24609,2,2001,2003,15,-121.478097,43.715172,"field  conductivity"
"6389",24610,1,2001,2002,4,-121.519353,43.709913,"field  conductivity"
"6390",24611,3,2001,2004,30,-121.516251,43.712803,"field  conductivity"
"6391",24612,2,2001,2003,19,-121.45929,43.830933,"field  conductivity"
"6392",24613,2,2001,2003,17,-121.499226,43.743467,"field  conductivity"
"6393",24614,2,2001,2003,22,-121.497529,43.702649,"field  conductivity"
"6394",24615,1,2002,2003,13,-121.461357,43.790607,"field  conductivity"
"6395",24616,2,2001,2003,8,-121.460158,43.830648,"field  conductivity"
"6396",24617,2,2001,2003,14,-121.459385,43.831098,"field  conductivity"
"6397",24618,2,2001,2003,16,-121.459356,43.831066,"field  conductivity"
"6398",24619,2,2001,2003,19,-121.459337,43.831026,"field  conductivity"
"6399",24621,2,2001,2003,10,-121.569532,43.639586,"field  conductivity"
"6400",24622,2,2001,2003,12,-121.569551,43.640423,"field  conductivity"
"6401",24623,2,2001,2003,11,-121.569551,43.64045,"field  conductivity"
"6402",24625,2,2001,2003,17,-121.568061,43.640232,"field  conductivity"
"6403",24627,2,2001,2003,16,-121.568106,43.640269,"field  conductivity"
"6404",24628,2,2001,2003,16,-121.568306,43.640127,"field  conductivity"
"6405",24630,1,2002,2003,6,-121.547567,43.702176,"field  conductivity"
"6406",24631,2,2001,2003,9,-121.54643,43.702207,"field  conductivity"
"6407",24632,2,2001,2003,9,-121.547207,43.701535,"field  conductivity"
"6408",24633,2,2002,2004,15,-121.547263,43.701555,"field  conductivity"
"6409",24634,3,2001,2004,24,-121.547058,43.701781,"field  conductivity"
"6410",24635,2,2001,2003,11,-121.522216,43.700471,"field  conductivity"
"6411",24636,2,2001,2003,10,-121.522209,43.701174,"field  conductivity"
"6412",24637,2,2001,2003,10,-121.52121,43.701268,"field  conductivity"
"6413",24639,2,2001,2003,17,-121.521416,43.700597,"field  conductivity"
"6414",24641,2,2001,2003,17,-121.521494,43.700592,"field  conductivity"
"6415",24642,2,2001,2003,15,-121.521424,43.700947,"field  conductivity"
"6416",24643,3,2001,2004,22,-121.519032,43.709907,"field  conductivity"
"6417",24644,2,2002,2004,19,-121.519575,43.709905,"field  conductivity"
"6418",24645,2,2002,2004,14,-121.516173,43.712769,"field  conductivity"
"6419",24646,3,2001,2004,20,-121.517581,43.712739,"field  conductivity"
"6420",24648,0,2001,2001,1,-121.460742,43.790434,"field  conductivity"
"6421",24649,0,2001,2001,2,-121.459396,43.831094,"field  conductivity"
"6422",24651,0,2009,2009,1,-123.21353,44.5791,"field  conductivity"
"6423",24655,2,2001,2003,17,-121.497325,43.702543,"field  conductivity"
"6424",24656,2,2001,2003,17,-121.49733,43.702518,"field  conductivity"
"6425",24657,2,2001,2003,30,-121.497359,43.702491,"field  conductivity"
"6426",24659,2,2001,2003,13,-121.476727,43.707493,"field  conductivity"
"6427",24661,2,2001,2003,9,-121.478107,43.714898,"field  conductivity"
"6428",24663,2,2001,2003,8,-121.478113,43.715387,"field  conductivity"
"6429",24664,2,2001,2003,13,-121.477723,43.714997,"field  conductivity"
"6430",24665,2,2001,2003,15,-121.495002,43.729247,"field  conductivity"
"6431",24666,2,2001,2003,15,-121.49539,43.729411,"field  conductivity"
"6432",24667,2,2001,2003,20,-121.495338,43.729463,"field  conductivity"
"6433",24668,2,2001,2003,11,-121.4598,43.794643,"field  conductivity"
"6434",24669,2,2001,2003,9,-121.477374,43.715312,"field  conductivity"
"6435",24670,2,2001,2003,8,-121.465205,43.821748,"field  conductivity"
"6436",24671,2,2001,2003,9,-121.465179,43.821325,"field  conductivity"
"6437",24672,2,2001,2003,9,-121.465463,43.821476,"field  conductivity"
"6438",24673,2,2001,2003,13,-121.460764,43.79042,"field  conductivity"
"6439",24674,2,2001,2003,14,-121.4608,43.790426,"field  conductivity"
"6440",24675,2,2001,2003,18,-121.460854,43.790442,"field  conductivity"
"6441",24676,10,2002,2012,4,-121.80452,42.17722,"field  conductivity"
"6442",24678,10,2002,2012,5,-121.80387,42.17511,"field  conductivity"
"6443",24679,10,2002,2012,4,-121.80475,42.1743,"field  conductivity"
"6444",24682,0,2001,2001,2,-121.497326,43.702575,"field  conductivity"
"6445",24683,2,2001,2003,14,-121.464178,43.824022,"field  conductivity"
"6446",24685,7,2002,2009,4,-123.1973,44.63145,"field  conductivity"
"6447",24690,2,2001,2003,13,-121.500523,43.742338,"field  conductivity"
"6448",24692,2,2001,2003,13,-121.500523,43.742372,"field  conductivity"
"6449",24696,0,2009,2009,2,-123.10714,44.54058,"field  conductivity"
"6450",24701,0,2009,2009,2,-123.10284,44.53886,"field  conductivity"
"6451",24712,0,2009,2009,1,-122.96089,44.6669,"field  conductivity"
"6452",24728,0,2002,2002,1,-122.95059,44.7079,"field  conductivity"
"6453",24732,0,2009,2009,1,-122.91704,44.65045,"field  conductivity"
"6454",24736,0,2009,2009,1,-123.18527,44.51069,"field  conductivity"
"6455",24738,7,2002,2009,3,-123.2099,44.40309,"field  conductivity"
"6456",24739,0,2009,2009,1,-123.20382,44.4415,"field  conductivity"
